lib,chrs,start,stop,cos,width
1,Chr1,3860253,3861371,3860812,1118
1,Chr1,13364993,13365101,13365047,108
1,Chr1,24171461,24171593,24171527,132
1,Chr2,7607906,7609452,7608679,1546
1,Chr2,15131495,15132128,15131811,633
1,Chr2,18745083,18745766,18745425,683
1,Chr3,1481467,1484211,1482839,2744
1,Chr3,16382698,16383206,16382952,508
1,Chr4,9359617,9359895,9359756,278
1,Chr5,6335545,6337115,6336330,1570
2,Chr1,1022802,1064221,1043512,41419
2,Chr1,8009431,8009847,8009639,416
2,Chr1,23144448,23146331,23145390,1883
2,Chr2,10191787,10192059,10191923,272
2,Chr2,11062997,11064318,11063657,1321
2,Chr2,14200926,14201457,14201192,531
2,Chr4,11995038,11995362,11995200,324
2,Chr5,716439,717534,716987,1095
2,Chr5,3049216,3049905,3049560,689
2,Chr5,4162280,4163047,4162664,767
2,Chr5,24375173,24375644,24375409,471
3,Chr1,17706157,17711388,17708773,5231
3,Chr1,25317948,25318499,25318224,551
3,Chr2,11752321,11752738,11752529,417
3,Chr2,11893097,11893997,11893547,900
3,Chr3,5060615,5061066,5060841,451
3,Chr3,10467447,10467494,10467471,47
3,Chr4,9182335,9194706,9188521,12371
3,Chr4,13226704,13227755,13227230,1051
3,Chr4,14523624,14524226,14523925,602
3,Chr5,2366787,2367234,2367011,447
3,Chr5,3368872,3369714,3369293,842
3,Chr5,4183996,4184107,4184052,111
3,Chr5,9717038,9717917,9717478,879
3,Chr5,17585038,17585895,17585466,857
3,Chr5,18708435,18709360,18708897,925
3,Chr5,26300463,26300918,26300691,455
4,Chr1,11396390,11397108,11396749,718
4,Chr1,23294647,23303404,23299025,8757
4,Chr1,23760857,23760969,23760913,112
4,Chr1,29263652,29265582,29264617,1930
4,Chr2,10045259,10045810,10045535,551
4,Chr2,13446171,13447970,13447071,1799
4,Chr3,7399050,7399062,7399056,12
4,Chr3,15971441,15971671,15971556,230
4,Chr3,19995081,19995870,19995475,789
4,Chr4,470805,471641,471223,836
4,Chr4,9737846,9737876,9737861,30
4,Chr4,16798975,16799377,16799176,402
4,Chr4,17747292,17747800,17747546,508
4,Chr5,7978365,7979855,7979110,1490
5,Chr1,1575785,1576310,1576047,525
5,Chr1,3265898,3266446,3266172,548
5,Chr1,13682792,13683572,13683182,780
5,Chr1,29868644,29869534,29869089,890
5,Chr2,9749036,9749269,9749152,233
5,Chr3,888150,889477,888814,1327
5,Chr3,15197018,15197251,15197134,233
5,Chr4,10763842,10764411,10764126,569
5,Chr4,16986855,16988189,16987522,1334
5,Chr5,19164004,19164027,19164016,23
5,Chr5,20561846,20561914,20561880,68
5,Chr5,24947359,24947561,24947460,202
5,Chr5,26627767,26627873,26627820,106
6,Chr1,2675754,2676164,2675959,410
6,Chr1,4212166,4212883,4212524,717
6,Chr1,10143465,10143911,10143688,446
6,Chr1,19423215,19424080,19423647,865
6,Chr2,7638458,7638630,7638544,172
6,Chr2,17464546,17465753,17465150,1207
6,Chr3,322925,323058,322991,133
6,Chr3,4500197,4502501,4501349,2304
6,Chr3,8898570,8899092,8898831,522
6,Chr3,18232776,18232998,18232887,222
6,Chr4,6817855,6819258,6818557,1403
6,Chr4,9679687,9680418,9680053,731
6,Chr4,10836415,10837366,10836891,951
6,Chr4,15862088,15863010,15862549,922
6,Chr5,124706,125339,125022,633
6,Chr5,10297543,10297904,10297723,361
6,Chr5,21278601,21278796,21278699,195
6,Chr5,24103892,24104579,24104236,687
7,Chr1,2901321,2901980,2901651,659
7,Chr1,6812214,6813411,6812812,1197
7,Chr1,8273520,8275176,8274348,1656
7,Chr1,11445872,11445988,11445930,116
7,Chr1,22926559,22926579,22926569,20
7,Chr1,25740148,25742572,25741360,2424
7,Chr1,29037547,29037749,29037648,202
7,Chr2,10213234,10213522,10213378,288
7,Chr2,10857222,10857466,10857344,244
7,Chr3,17537015,17537823,17537419,808
7,Chr3,17945438,17945561,17945500,123
7,Chr4,7238999,7241036,7240017,2037
7,Chr5,703558,705240,704399,1682
7,Chr5,21333534,21334273,21333904,739
8,Chr1,1238377,1238774,1238575,397
8,Chr1,6516167,6516216,6516191,49
8,Chr1,12301122,12301146,12301134,24
8,Chr1,22874457,22874535,22874496,78
8,Chr1,25429125,25429188,25429157,63
8,Chr2,1077365,1078278,1077821,913
8,Chr2,10858811,10859675,10859243,864
8,Chr2,16522581,16525421,16524001,2840
8,Chr3,388609,389200,388905,591
8,Chr3,6268794,6269074,6268934,280
8,Chr3,16256997,16282145,16269571,25148
8,Chr3,20948468,20950128,20949298,1660
8,Chr3,23288544,23288969,23288756,425
8,Chr4,7145341,7145784,7145563,443
8,Chr4,10808817,10809464,10809141,647
8,Chr5,15887303,15887386,15887345,83
8,Chr5,23225153,23225545,23225349,392
9,Chr1,2233557,2233728,2233643,171
9,Chr1,4876547,4877062,4876805,515
9,Chr1,12971762,12972141,12971952,379
9,Chr1,22490771,22490925,22490848,154
9,Chr1,22507357,22508576,22507967,1219
9,Chr1,24442597,24442600,24442599,3
9,Chr2,2323121,2323274,2323197,153
9,Chr2,13289000,13290694,13289847,1694
9,Chr2,14196990,14199880,14198435,2890
9,Chr3,16580826,16581125,16580976,299
9,Chr3,17951730,17951737,17951734,7
9,Chr3,19715853,19716537,19716195,684
9,Chr3,20557623,20557633,20557628,10
9,Chr5,16999350,16999774,16999562,424
10,Chr1,6794038,6794923,6794480,885
10,Chr1,11079746,11080378,11080062,632
10,Chr1,23366964,23367055,23367010,91
10,Chr2,12943695,12944376,12944035,681
10,Chr3,1911270,1911776,1911523,506
10,Chr3,4258788,4259107,4258948,319
10,Chr4,960221,960459,960340,238
10,Chr4,5372087,5373673,5372880,1586
10,Chr4,15486398,15487614,15487006,1216
10,Chr4,16778605,16791271,16784938,12666
10,Chr4,17335359,17336929,17336144,1570
10,Chr5,16669939,16670319,16670129,380
11,Chr1,7040667,7041074,7040871,407
11,Chr1,11470992,11471209,11471100,217
11,Chr1,20427915,20432377,20430146,4462
11,Chr1,26512176,26514127,26513152,1951
11,Chr2,357270,357386,357328,116
11,Chr2,10313875,10314432,10314153,557
11,Chr2,19212639,19214504,19213571,1865
11,Chr3,951654,952056,951855,402
11,Chr3,4311744,4312670,4312207,926
11,Chr3,4496216,4496333,4496274,117
11,Chr3,19168104,19168480,19168292,376
11,Chr4,7716147,7717612,7716879,1465
11,Chr4,15359102,15359931,15359516,829
11,Chr5,3339170,3339392,3339281,222
11,Chr5,3995124,3995471,3995298,347
11,Chr5,19031054,19031166,19031110,112
11,Chr5,21942681,21943544,21943113,863
11,Chr5,25200627,25201992,25201309,1365
11,Chr5,25815643,25818571,25817107,2928
12,Chr1,7890504,7890857,7890680,353
12,Chr1,10708763,10711732,10710247,2969
12,Chr1,11222439,11222575,11222507,136
12,Chr1,11443642,11443821,11443732,179
12,Chr1,22807367,22807456,22807411,89
12,Chr1,25312144,25312324,25312234,180
12,Chr1,27306207,27306451,27306329,244
12,Chr2,1934037,1934057,1934047,20
12,Chr2,11086280,11087047,11086664,767
12,Chr3,4789502,4789650,4789576,148
12,Chr3,5409713,5410560,5410137,847
12,Chr3,10380224,10380499,10380362,275
12,Chr3,14942856,14943162,14943009,306
12,Chr4,6300120,6300295,6300208,175
12,Chr4,10255553,10255656,10255605,103
12,Chr5,6033788,6034324,6034056,536
12,Chr5,8784472,8786457,8785464,1985
12,Chr5,17215735,17216172,17215953,437
12,Chr5,19871001,19871114,19871057,113
12,Chr5,22848175,22850026,22849101,1851
12,Chr5,25423067,25424869,25423968,1802
12,Chr5,25497609,25497956,25497783,347
13,Chr1,4193806,4194580,4194193,774
13,Chr1,20746303,20746406,20746355,103
13,Chr1,23292509,23292940,23292725,431
13,Chr1,26514850,26517661,26516256,2811
13,Chr2,8847594,8847654,8847624,60
13,Chr3,1061135,1061297,1061216,162
13,Chr4,852842,853530,853186,688
13,Chr4,7071036,7071239,7071138,203
13,Chr4,17227367,17227430,17227399,63
13,Chr5,19973584,19975085,19974334,1501
13,Chr5,23415327,23415423,23415375,96
14,Chr1,4892929,4893442,4893185,513
14,Chr1,7099357,7101496,7100427,2139
14,Chr1,9253745,9253881,9253813,136
14,Chr1,18787650,18788121,18787886,471
14,Chr1,22795877,22796050,22795963,173
14,Chr1,23946892,23946998,23946945,106
14,Chr1,27421315,27426586,27423951,5271
14,Chr2,1024631,1024683,1024657,52
14,Chr2,10285963,10287209,10286586,1246
14,Chr2,16123371,16123937,16123654,566
14,Chr3,6359894,6360171,6360032,277
14,Chr3,11466322,11466603,11466462,281
14,Chr4,14393962,14394705,14394334,743
14,Chr4,15942129,15946048,15944089,3919
14,Chr5,18574334,18575078,18574706,744
14,Chr5,24102246,24102290,24102268,44
14,Chr5,25679472,25679795,25679634,323
15,Chr1,6697535,6697597,6697566,62
15,Chr1,22009647,22011083,22010365,1436
15,Chr2,6866110,6866539,6866324,429
15,Chr2,14984371,14986234,14985303,1863
15,Chr3,335714,336801,336258,1087
15,Chr3,20633150,20633236,20633193,86
15,Chr4,9815925,9818112,9817019,2187
15,Chr4,10287974,10288644,10288309,670
15,Chr4,17641542,17641843,17641692,301
15,Chr5,10482955,10483404,10483179,449
15,Chr5,13661135,13661775,13661455,640
16,Chr1,4085126,4086107,4085616,981
16,Chr1,13006418,13012852,13009635,6434
16,Chr1,16134241,16134574,16134407,333
16,Chr1,18131661,18131740,18131701,79
16,Chr1,20107294,20107393,20107344,99
16,Chr1,20745260,20745484,20745372,224
16,Chr1,22088409,22088511,22088460,102
16,Chr1,27148386,27148768,27148577,382
16,Chr2,6793356,6795275,6794316,1919
16,Chr2,17240048,17240156,17240102,108
16,Chr3,3583916,3585416,3584666,1500
16,Chr3,10606069,10606198,10606133,129
16,Chr3,18511758,18511973,18511866,215
16,Chr4,495738,496571,496154,833
16,Chr4,8594854,8596189,8595522,1335
16,Chr4,11151587,11152043,11151815,456
16,Chr4,15194757,15195167,15194962,410
16,Chr5,5605846,5609634,5607740,3788
16,Chr5,16057456,16057886,16057671,430
16,Chr5,17627115,17627645,17627380,530
17,Chr1,17382278,17383041,17382660,763
17,Chr1,23685884,23686086,23685985,202
17,Chr1,28953105,28953663,28953384,558
17,Chr3,10618021,10618449,10618235,428
17,Chr4,8860345,8863768,8862057,3423
17,Chr4,13513943,13514762,13514353,819
17,Chr5,1656411,1656756,1656583,345
17,Chr5,4271956,4272083,4272020,127
17,Chr5,5440231,5440770,5440501,539
18,Chr1,4766768,4767090,4766929,322
18,Chr1,5508567,5508718,5508643,151
18,Chr1,17419423,17419496,17419459,73
18,Chr1,27306451,27306594,27306523,143
18,Chr2,1521937,1522811,1522374,874
18,Chr2,2181296,2182064,2181680,768
18,Chr2,7946958,7946996,7946977,38
18,Chr2,18907469,18907831,18907650,362
18,Chr3,6488550,6492973,6490762,4423
18,Chr3,9054363,9054752,9054557,389
18,Chr3,18375979,18376534,18376257,555
18,Chr3,23040537,23040682,23040609,145
18,Chr4,6217676,6218291,6217984,615
18,Chr4,7149748,7149811,7149780,63
18,Chr4,16100563,16101321,16100942,758
18,Chr5,7486894,7486946,7486920,52
18,Chr5,10873198,10873275,10873236,77
18,Chr5,15250052,15250387,15250220,335
18,Chr5,18163075,18164011,18163543,936
18,Chr5,21780372,21780950,21780661,578
19,Chr1,3270896,3271066,3270981,170
19,Chr1,5522421,5523865,5523143,1444
19,Chr1,6089648,6090247,6089948,599
19,Chr1,7099357,7101496,7100427,2139
19,Chr1,17298520,17299673,17299096,1153
19,Chr1,18286897,18288175,18287536,1278
19,Chr1,26514850,26517661,26516256,2811
19,Chr2,9552489,9552582,9552535,93
19,Chr2,16242732,16242792,16242762,60
19,Chr3,3460106,3460130,3460118,24
19,Chr3,5746408,5748134,5747271,1726
19,Chr4,8420779,8422200,8421489,1421
19,Chr4,10104561,10104733,10104647,172
19,Chr4,17402640,17404315,17403478,1675
19,Chr5,21181548,21182277,21181912,729
19,Chr5,25699402,25699539,25699470,137
20,Chr1,4782078,4783252,4782665,1174
20,Chr1,5424830,5425216,5425023,386
20,Chr1,16483358,16483582,16483470,224
20,Chr1,23311184,23311685,23311434,501
20,Chr1,26734234,26734278,26734256,44
20,Chr2,2286312,2287228,2286770,916
20,Chr2,11012479,11013424,11012951,945
20,Chr2,19150912,19151433,19151172,521
20,Chr3,2771343,2771918,2771631,575
20,Chr3,4388703,4388771,4388737,68
20,Chr3,15666043,15666140,15666091,97
20,Chr3,16809178,16809271,16809224,93
20,Chr3,17621079,17621524,17621301,445
20,Chr3,20357629,20357845,20357737,216
20,Chr3,21133829,21134610,21134219,781
20,Chr4,375478,375613,375546,135
20,Chr4,8215901,8216539,8216220,638
20,Chr4,16533765,16534482,16534123,717
20,Chr4,16692815,16692940,16692877,125
20,Chr5,1771593,1771753,1771673,160
20,Chr5,13233478,13234114,13233796,636
20,Chr5,14018187,14022516,14020351,4329
20,Chr5,25617595,25618132,25617863,537
21,Chr1,3691561,3691586,3691573,25
21,Chr1,19602372,19604495,19603434,2123
21,Chr1,25539380,25549775,25544578,10395
21,Chr2,1058394,1059538,1058966,1144
21,Chr2,6761302,6763833,6762568,2531
21,Chr2,11926077,11926797,11926437,720
21,Chr2,15988602,15988690,15988646,88
21,Chr3,22743465,22744128,22743797,663
21,Chr4,604723,605326,605025,603
21,Chr4,8822631,8822688,8822659,57
21,Chr4,12769558,12770274,12769916,716
21,Chr5,10488717,10488855,10488786,138
21,Chr5,23675192,23675895,23675544,703
22,Chr1,8155374,8156288,8155831,914
22,Chr1,11012385,11012465,11012425,80
22,Chr1,11758556,11759744,11759150,1188
22,Chr1,21919729,21919852,21919791,123
22,Chr2,10206396,10206542,10206469,146
22,Chr3,8641426,8641648,8641537,222
22,Chr3,20719328,20719366,20719347,38
22,Chr3,21900304,21900438,21900371,134
22,Chr4,72008,72509,72258,501
22,Chr4,5427613,5427850,5427731,237
22,Chr5,8294496,8294663,8294580,167
22,Chr5,14064865,14064947,14064906,82
22,Chr5,15249032,15249580,15249306,548
22,Chr5,18802537,18802646,18802591,109
22,Chr5,21719532,21719995,21719764,463
22,Chr5,24696098,24700114,24698106,4016
23,Chr1,3260105,3260806,3260455,701
23,Chr1,7848904,7849532,7849218,628
23,Chr1,29164378,29164439,29164408,61
23,Chr2,6456287,6456721,6456504,434
23,Chr2,8947922,8947991,8947956,69
23,Chr2,13192090,13195264,13193677,3174
23,Chr2,18690308,18691564,18690936,1256
23,Chr3,7647088,7647898,7647493,810
23,Chr3,23016150,23021445,23018798,5295
23,Chr4,644882,644938,644910,56
23,Chr4,1156421,1157095,1156758,674
23,Chr5,3211634,3212786,3212210,1152
23,Chr5,13907872,13909662,13908767,1790
23,Chr5,26601627,26601802,26601715,175
24,Chr1,2213217,2213284,2213251,67
24,Chr1,8202717,8202898,8202807,181
24,Chr1,10971829,10972165,10971997,336
24,Chr1,13140432,13140606,13140519,174
24,Chr1,20522102,20523543,20522822,1441
24,Chr1,26666672,26667246,26666959,574
24,Chr1,28877269,28882651,28879960,5382
24,Chr2,1977549,1989878,1983713,12329
24,Chr2,7184366,7184797,7184582,431
24,Chr2,12101343,12104379,12102861,3036
24,Chr2,18307129,18308756,18307943,1627
24,Chr3,501450,502247,501848,797
24,Chr3,7425669,7427184,7426427,1515
24,Chr3,21228349,21228655,21228502,306
24,Chr4,10288763,10289158,10288961,395
24,Chr5,874030,874734,874382,704
24,Chr5,8240927,8241073,8241000,146
24,Chr5,25753586,25753717,25753652,131
25,Chr1,1543645,1543802,1543723,157
25,Chr1,6359187,6361020,6360103,1833
25,Chr1,18220661,18222447,18221554,1786
25,Chr1,18772500,18772559,18772530,59
25,Chr1,28232326,28232943,28232634,617
25,Chr2,297361,298576,297969,1215
25,Chr2,1142741,1142762,1142751,21
25,Chr2,11769434,11770706,11770070,1272
25,Chr2,12287525,12288280,12287903,755
25,Chr3,2806602,2807346,2806974,744
25,Chr3,16583293,16587858,16585575,4565
25,Chr4,2916661,3293710,3105185,377049
25,Chr4,15276904,15277555,15277230,651
25,Chr5,1523516,1523729,1523622,213
25,Chr5,4956408,4957536,4956972,1128
25,Chr5,14919503,14919646,14919575,143
25,Chr5,17634840,17634874,17634857,34
26,Chr1,2439590,2441778,2440684,2188
26,Chr1,3480237,3480382,3480309,145
26,Chr1,3928436,3929277,3928856,841
26,Chr1,24746703,24746863,24746783,160
26,Chr2,11124754,11125185,11124970,431
26,Chr3,2460862,2462662,2461762,1800
26,Chr3,22928437,22928834,22928635,397
26,Chr4,7757990,7758687,7758338,697
26,Chr4,16709282,16709405,16709344,123
26,Chr5,8110578,8112033,8111306,1455
27,Chr1,1207742,1208938,1208340,1196
27,Chr1,5324844,5325156,5325000,312
27,Chr1,7317637,7318766,7318201,1129
27,Chr1,16473701,16473766,16473733,65
27,Chr1,17856825,17857859,17857342,1034
27,Chr1,25023744,25023913,25023828,169
27,Chr1,26683300,26683938,26683619,638
27,Chr2,16052681,16053664,16053173,983
27,Chr3,2167711,2168963,2168337,1252
27,Chr3,4102643,4103514,4103079,871
27,Chr3,4634444,4634914,4634679,470
27,Chr3,9403592,9403661,9403626,69
27,Chr3,16924542,16924683,16924612,141
27,Chr4,1047332,1048128,1047730,796
27,Chr4,1378592,1378722,1378657,130
27,Chr4,15959608,15960336,15959972,728
27,Chr5,10016821,10017049,10016935,228
27,Chr5,22208310,22209629,22208970,1319
27,Chr5,24447314,24448519,24447916,1205
28,Chr1,20955346,20955483,20955414,137
28,Chr2,9872668,9873628,9873148,960
28,Chr2,16129998,16131129,16130564,1131
28,Chr2,16858519,16859273,16858896,754
28,Chr2,17722465,17723840,17723153,1375
28,Chr3,1038588,1038840,1038714,252
28,Chr3,11501014,11501336,11501175,322
28,Chr3,17267346,17268876,17268111,1530
28,Chr3,19287944,19291306,19289625,3362
28,Chr4,6191345,6191743,6191544,398
28,Chr5,5406334,5406651,5406492,317
28,Chr5,16650731,16650787,16650759,56
28,Chr5,20410278,20410477,20410378,199
28,Chr5,25792753,25794984,25793869,2231
29,Chr1,2630076,2630806,2630441,730
29,Chr1,7182151,7182332,7182241,181
29,Chr1,21250036,21250320,21250178,284
29,Chr1,23471950,23472158,23472054,208
29,Chr2,478358,478598,478478,240
29,Chr2,5415204,5415210,5415207,6
29,Chr2,10215556,10215775,10215666,219
29,Chr2,10821802,10821942,10821872,140
29,Chr2,13394927,13395609,13395268,682
29,Chr2,19170753,19171268,19171011,515
29,Chr3,3714859,3717750,3716305,2891
29,Chr3,19908032,19908151,19908092,119
29,Chr3,23313158,23313464,23313311,306
29,Chr4,1045752,1047090,1046421,1338
29,Chr4,6678935,6679002,6678969,67
29,Chr4,6975440,6976826,6976133,1386
29,Chr4,12261708,12261755,12261732,47
29,Chr5,9713163,9716705,9714934,3542
30,Chr1,2284235,2284698,2284467,463
30,Chr1,8966237,8967311,8966774,1074
30,Chr1,19579258,19579320,19579289,62
30,Chr1,20812489,20812739,20812614,250
30,Chr2,6245233,6245247,6245240,14
30,Chr2,9208789,9209623,9209206,834
30,Chr2,13018058,13018475,13018266,417
30,Chr2,16705075,16705595,16705335,520
30,Chr4,976581,983150,979865,6569
30,Chr4,5800611,5802615,5801613,2004
30,Chr5,623438,623749,623594,311
30,Chr5,3141165,3141794,3141479,629
30,Chr5,7457713,7457751,7457732,38
30,Chr5,21123477,21126754,21125115,3277
31,Chr1,4628055,4628505,4628280,450
31,Chr1,5360977,5361654,5361315,677
31,Chr1,24488530,24489723,24489126,1193
31,Chr2,1716138,1716220,1716179,82
31,Chr2,9905997,9906670,9906333,673
31,Chr2,10653551,10653584,10653567,33
31,Chr2,19050728,19051443,19051086,715
31,Chr3,4089551,4091586,4090569,2035
31,Chr3,11876603,11904923,11890763,28320
31,Chr3,17551986,17552472,17552229,486
31,Chr3,21894412,21894629,21894520,217
31,Chr4,10719602,10720281,10719942,679
31,Chr4,16730988,16731358,16731173,370
31,Chr5,5254647,5254811,5254729,164
31,Chr5,21669571,21669877,21669724,306
31,Chr5,25978794,25979012,25978903,218
32,Chr1,7815348,7816024,7815686,676
32,Chr1,8794202,8863706,8828954,69504
32,Chr1,17566565,17566796,17566681,231
32,Chr2,1273809,1275028,1274419,1219
32,Chr2,9904715,9905215,9904965,500
32,Chr2,11205860,11207733,11206796,1873
32,Chr2,16150039,16150130,16150085,91
32,Chr3,3991607,3993573,3992590,1966
32,Chr3,16618791,16619202,16618997,411
32,Chr4,6425346,6425950,6425648,604
32,Chr4,7077920,7077932,7077926,12
32,Chr4,10293962,10294164,10294063,202
32,Chr5,7005303,7005863,7005583,560
32,Chr5,16591768,16591976,16591872,208
32,Chr5,17606521,17607351,17606936,830
33,Chr1,8380361,8391346,8385853,10985
33,Chr1,20060397,20060592,20060495,195
33,Chr2,19416969,19417549,19417259,580
33,Chr3,9212374,9213039,9212706,665
33,Chr4,12835870,12836029,12835950,159
33,Chr5,3807597,3810280,3808939,2683
33,Chr5,10188097,10189297,10188697,1200
33,Chr5,15069796,15069860,15069828,64
33,Chr5,23966576,23966861,23966718,285
34,Chr1,7090945,7091829,7091387,884
34,Chr1,17293423,17294160,17293791,737
34,Chr1,19940046,19945899,19942972,5853
34,Chr1,22088585,22110941,22099763,22356
34,Chr1,27535846,27535997,27535922,151
34,Chr2,1697105,1697258,1697181,153
34,Chr3,206914,207447,207180,533
34,Chr3,7912449,7912730,7912589,281
34,Chr3,9760510,9760895,9760702,385
34,Chr3,21830225,21830343,21830284,118
34,Chr4,10489783,10490390,10490087,607
34,Chr4,17523824,17524106,17523965,282
34,Chr4,18143608,18144120,18143864,512
34,Chr5,1263136,1263403,1263270,267
34,Chr5,8778240,8778323,8778282,83
34,Chr5,10265657,10265846,10265751,189
34,Chr5,21980310,21980896,21980603,586
34,Chr5,22681723,22683923,22682823,2200
35,Chr1,4059066,4059151,4059108,85
35,Chr1,6443656,6443688,6443672,32
35,Chr1,17712495,17712636,17712565,141
35,Chr2,354421,355286,354853,865
35,Chr2,6035326,6035766,6035546,440
35,Chr2,7285844,7285994,7285919,150
35,Chr3,467748,467969,467858,221
35,Chr3,6717716,6717773,6717744,57
35,Chr3,7867266,7868437,7867852,1171
35,Chr3,21786698,21787423,21787060,725
35,Chr4,6836105,6837468,6836787,1363
35,Chr4,15937111,15937860,15937485,749
35,Chr4,16523004,16524239,16523622,1235
35,Chr4,17347188,17348543,17347866,1355
35,Chr5,4539367,4540030,4539699,663
35,Chr5,9713163,9717038,9715101,3875
35,Chr5,21720582,21721374,21720978,792
36,Chr1,432021,432547,432284,526
36,Chr1,2209436,2211127,2210282,1691
36,Chr1,6384915,6385564,6385239,649
36,Chr1,6871474,6871759,6871616,285
36,Chr1,10573243,10574632,10573937,1389
36,Chr1,19095286,19095299,19095292,13
36,Chr1,20159710,20159813,20159762,103
36,Chr1,23018105,23019579,23018842,1474
36,Chr1,26695316,26695711,26695514,395
36,Chr1,28315680,28316802,28316241,1122
36,Chr2,756138,756251,756194,113
36,Chr2,7703696,7704659,7704178,963
36,Chr2,10329334,10330093,10329714,759
36,Chr2,12871471,12871691,12871581,220
36,Chr2,19048343,19050712,19049527,2369
36,Chr3,17240032,17240075,17240054,43
36,Chr4,491702,492590,492146,888
36,Chr4,587124,587634,587379,510
36,Chr4,9727949,9728303,9728126,354
36,Chr5,7655316,7656147,7655732,831
36,Chr5,22642428,22642623,22642526,195
36,Chr5,26461716,26461732,26461724,16
37,Chr1,2879276,2879396,2879336,120
37,Chr1,9331592,9332398,9331995,806
37,Chr1,16473766,16474232,16473999,466
37,Chr1,23221706,23223509,23222608,1803
37,Chr2,6686955,6688048,6687501,1093
37,Chr2,10783048,10786591,10784820,3543
37,Chr3,2563680,2563741,2563710,61
37,Chr3,3974242,3977337,3975790,3095
37,Chr3,11807089,11807309,11807199,220
37,Chr3,18666308,18668323,18667316,2015
37,Chr4,5722965,5723568,5723267,603
37,Chr4,9905531,9905610,9905571,79
37,Chr4,15634561,15634801,15634681,240
37,Chr4,17781786,17782363,17782074,577
37,Chr5,19164004,19164027,19164016,23
37,Chr5,24464753,24465162,24464957,409
38,Chr1,7834172,7835077,7834624,905
38,Chr1,10694804,10695022,10694913,218
38,Chr2,1429785,1430352,1430069,567
38,Chr2,7946189,7946243,7946216,54
38,Chr2,8941613,8941636,8941625,23
38,Chr3,447099,450845,448972,3746
38,Chr3,3866594,3867515,3867054,921
38,Chr3,10382180,10383352,10382766,1172
38,Chr4,6796696,6796827,6796762,131
38,Chr4,9104456,9104504,9104480,48
38,Chr4,15363314,15363443,15363378,129
38,Chr4,17698360,17699056,17698708,696
38,Chr5,4575696,4576228,4575962,532
38,Chr5,17144954,17145346,17145150,392
38,Chr5,20562771,20562856,20562813,85
39,Chr1,7775464,7775538,7775501,74
39,Chr1,9092461,9094151,9093306,1690
39,Chr2,494005,494756,494381,751
39,Chr2,6867865,6867901,6867883,36
39,Chr2,18934057,18935013,18934535,956
39,Chr3,901089,903086,902087,1997
39,Chr3,4127027,4127655,4127341,628
39,Chr3,6464345,6465041,6464693,696
39,Chr3,8245205,8245297,8245251,92
39,Chr3,10075214,10075343,10075278,129
39,Chr4,658722,660712,659717,1990
39,Chr5,14106312,14106585,14106448,273
39,Chr5,20941731,20942002,20941867,271
39,Chr5,25034199,25035669,25034934,1470
40,Chr1,6670095,6672437,6671266,2342
40,Chr1,9406127,9406222,9406175,95
40,Chr1,10062158,10062941,10062550,783
40,Chr1,12534348,12535774,12535061,1426
40,Chr1,18122287,18123031,18122659,744
40,Chr2,13712982,13713109,13713046,127
40,Chr3,15972713,15972758,15972735,45
40,Chr3,21061318,21061366,21061342,48
40,Chr4,307756,308062,307909,306
40,Chr4,5645086,5646362,5645724,1276
40,Chr4,8097383,8097493,8097438,110
40,Chr4,16310211,16310481,16310346,270
40,Chr5,945209,945582,945395,373
40,Chr5,6257707,6258120,6257913,413
40,Chr5,15726871,15726914,15726893,43
40,Chr5,22174106,22174141,22174124,35
41,Chr1,2984251,2985586,2984919,1335
41,Chr1,3226982,3227162,3227072,180
41,Chr1,3680796,3681272,3681034,476
41,Chr1,7660055,7660913,7660484,858
41,Chr1,17220534,17220713,17220624,179
41,Chr2,6651373,6652029,6651701,656
41,Chr2,10022736,10030404,10026570,7668
41,Chr2,18789322,18789457,18789390,135
41,Chr3,18804021,18804835,18804428,814
41,Chr3,20873132,20873567,20873350,435
41,Chr3,22692691,22693158,22692925,467
41,Chr4,1431913,1432609,1432261,696
41,Chr4,6390978,6390998,6390988,20
41,Chr4,7635896,7636255,7636076,359
41,Chr5,8004596,8004718,8004657,122
41,Chr5,17446103,17446964,17446533,861
41,Chr5,19985762,19986653,19986208,891
42,Chr1,10976688,10977083,10976886,395
42,Chr2,10110449,10111139,10110794,690
42,Chr3,2541039,2542530,2541785,1491
42,Chr3,2950187,2952858,2951523,2671
42,Chr3,21772830,21775137,21773984,2307
42,Chr3,22414742,22415188,22414965,446
42,Chr3,23046212,23046959,23046586,747
42,Chr4,134356,134493,134424,137
42,Chr4,7677786,7678441,7678114,655
42,Chr5,737827,738689,738258,862
42,Chr5,6671956,6672500,6672228,544
42,Chr5,9652887,9652980,9652933,93
42,Chr5,21109460,21110259,21109860,799
43,Chr1,1884961,1885208,1885085,247
43,Chr1,4628505,4629613,4629059,1108
43,Chr1,16307785,16308345,16308065,560
43,Chr1,25275454,25276330,25275892,876
43,Chr2,251021,251332,251177,311
43,Chr2,8550104,8551940,8551022,1836
43,Chr3,766469,766616,766543,147
43,Chr3,19270598,19270841,19270720,243
43,Chr4,6583694,6583828,6583761,134
43,Chr4,10177952,10178269,10178110,317
43,Chr4,16317167,16318223,16317695,1056
43,Chr5,3211634,3212744,3212189,1110
43,Chr5,9812067,9812475,9812271,408
43,Chr5,14564208,14564388,14564298,180
43,Chr5,22076072,22077982,22077027,1910
43,Chr5,26132879,26133929,26133404,1050
43,Chr5,26688668,26689017,26688842,349
44,Chr1,1123880,1124879,1124380,999
44,Chr1,2386860,2387932,2387396,1072
44,Chr1,17283616,17284161,17283888,545
44,Chr1,20457066,20457724,20457395,658
44,Chr2,362656,365116,363886,2460
44,Chr2,6801370,6802479,6801924,1109
44,Chr2,7671019,7671081,7671050,62
44,Chr3,5426434,5427607,5427020,1173
44,Chr3,9739239,9739246,9739243,7
44,Chr3,9992022,9992503,9992262,481
44,Chr3,22158623,22159066,22158845,443
44,Chr4,14151122,14151354,14151238,232
44,Chr5,9047956,9047987,9047972,31
44,Chr5,9935521,9936108,9935815,587
44,Chr5,15914941,15915730,15915335,789
45,Chr1,1217472,1217632,1217552,160
45,Chr1,2822649,2825256,2823953,2607
45,Chr1,9635655,9637582,9636619,1927
45,Chr1,23654076,23654331,23654204,255
45,Chr1,24794940,24796453,24795696,1513
45,Chr2,15813953,15815518,15814735,1565
45,Chr3,500178,500387,500282,209
45,Chr4,8389501,8391544,8390523,2043
45,Chr4,18296952,18297269,18297110,317
45,Chr5,6997812,6998195,6998004,383
45,Chr5,9864589,9864664,9864627,75
45,Chr5,15225141,15225817,15225479,676
45,Chr5,21855409,21855957,21855683,548
46,Chr1,6677546,6677919,6677732,373
46,Chr2,1321796,1326625,1324210,4829
46,Chr2,17165478,17166948,17166213,1470
46,Chr3,15738352,15738443,15738398,91
46,Chr3,19453048,19453992,19453520,944
46,Chr4,15194757,15195167,15194962,410
46,Chr5,1948574,1948687,1948630,113
46,Chr5,5766860,5767051,5766956,191
46,Chr5,7226239,7226506,7226373,267
46,Chr5,10646250,10646323,10646286,73
46,Chr5,20052165,20053529,20052847,1364
46,Chr5,25360060,25361087,25360574,1027
47,Chr1,4045808,4045873,4045840,65
47,Chr1,4867069,4867868,4867469,799
47,Chr1,29841672,29841831,29841752,159
47,Chr2,624477,626597,625537,2120
47,Chr2,9678509,9679280,9678895,771
47,Chr3,2567484,2567935,2567710,451
47,Chr4,8106113,8107567,8106840,1454
47,Chr4,18210972,18213701,18212336,2729
47,Chr5,463361,464507,463934,1146
47,Chr5,4765724,4765967,4765846,243
47,Chr5,9497847,9498058,9497953,211
47,Chr5,20386349,20386597,20386473,248
47,Chr5,24731066,24731464,24731265,398
48,Chr1,1545726,1545758,1545742,32
48,Chr1,4542707,4543015,4542861,308
48,Chr1,10053836,10054196,10054016,360
48,Chr1,27093802,27093870,27093836,68
48,Chr1,30242682,30242922,30242802,240
48,Chr2,8371410,8371936,8371673,526
48,Chr2,18381452,18382443,18381948,991
48,Chr2,19392568,19393559,19393064,991
48,Chr3,6902332,6902933,6902632,601
48,Chr3,9498878,9499295,9499086,417
48,Chr3,20802638,20802697,20802668,59
48,Chr3,22271248,22274835,22273042,3587
48,Chr4,1401345,1403111,1402228,1766
48,Chr4,17387408,17387798,17387603,390
48,Chr5,2195262,2195750,2195506,488
48,Chr5,3108598,3108950,3108774,352
48,Chr5,8289822,8290084,8289953,262
48,Chr5,14990813,14990861,14990837,48
48,Chr5,25357125,25357395,25357260,270
49,Chr1,4288731,4288845,4288788,114
49,Chr1,16781366,16781712,16781539,346
49,Chr1,17865725,17866252,17865989,527
49,Chr1,26239481,26239782,26239631,301
49,Chr1,29184175,29184778,29184477,603
49,Chr2,6239009,6240096,6239553,1087
49,Chr2,18516505,18520378,18518441,3873
49,Chr2,19407814,19408508,19408161,694
49,Chr3,8959326,8959780,8959553,454
49,Chr3,20604259,20604556,20604407,297
49,Chr4,658406,660712,659559,2306
49,Chr4,14814970,14816398,14815684,1428
49,Chr5,4621919,4622326,4622123,407
49,Chr5,23277632,23279035,23278334,1403
50,Chr1,6977329,6980681,6979005,3352
50,Chr1,20813510,20813552,20813531,42
50,Chr1,25617612,25618047,25617830,435
50,Chr2,10532004,10532287,10532146,283
50,Chr3,2519481,2520461,2519971,980
50,Chr3,6705940,6709958,6707949,4018
50,Chr3,7138348,7138938,7138643,590
50,Chr3,9549053,9549406,9549229,353
50,Chr3,16497707,16497793,16497750,86
50,Chr4,5445002,5445207,5445104,205
50,Chr5,16106719,16107603,16107161,884
50,Chr5,20423446,20425943,20424694,2497
50,Chr5,21447088,21448271,21447680,1183
50,Chr5,26097306,26097460,26097383,154
51,Chr1,1574398,1575118,1574758,720
51,Chr1,9962930,9964489,9963710,1559
51,Chr1,13077108,13077389,13077248,281
51,Chr1,20276105,20283980,20280043,7875
51,Chr2,1025193,1025524,1025359,331
51,Chr2,7001170,7001263,7001216,93
51,Chr2,12154421,12155437,12154929,1016
51,Chr2,19282018,19285498,19283758,3480
51,Chr3,540188,540725,540456,537
51,Chr3,6230346,6230444,6230395,98
51,Chr3,9489007,9489361,9489184,354
51,Chr3,16370019,16370203,16370111,184
51,Chr3,19138062,19138255,19138158,193
51,Chr4,1153954,1154102,1154028,148
51,Chr4,13715835,13716591,13716213,756
51,Chr4,14577997,14578707,14578352,710
51,Chr4,14807746,14810063,14808904,2317
51,Chr5,556436,556520,556478,84
51,Chr5,9076686,9077649,9077168,963
51,Chr5,10263726,10264141,10263934,415
51,Chr5,23279035,23280509,23279772,1474
52,Chr1,591492,591513,591502,21
52,Chr1,16575816,16576014,16575915,198
52,Chr1,23138976,23138993,23138984,17
52,Chr1,29183103,29183540,29183321,437
52,Chr2,145219,145364,145291,145
52,Chr2,10460368,10460828,10460598,460
52,Chr2,16543748,16545260,16544504,1512
52,Chr3,633695,633884,633789,189
52,Chr3,18198774,18199016,18198895,242
52,Chr3,19152852,19158051,19155452,5199
52,Chr4,724139,726816,725477,2677
52,Chr4,7816423,7849163,7832793,32740
52,Chr4,10145432,10145641,10145536,209
52,Chr4,15872552,15873384,15872968,832
52,Chr5,1503421,1504573,1503997,1152
52,Chr5,19604737,19604838,19604787,101
52,Chr5,21366812,21366930,21366871,118
53,Chr1,1429954,1430141,1430048,187
53,Chr1,26679121,26679859,26679490,738
53,Chr2,5831642,5831880,5831761,238
53,Chr2,8805032,8805136,8805084,104
53,Chr2,13982741,13983683,13983212,942
53,Chr3,1759855,1760783,1760319,928
53,Chr3,10143317,10143420,10143369,103
53,Chr3,20648711,20648899,20648805,188
53,Chr4,5983821,5984686,5984253,865
53,Chr4,15674018,15674064,15674041,46
53,Chr5,4730492,4732136,4731314,1644
53,Chr5,8996860,8999455,8998158,2595
53,Chr5,18988421,18988542,18988481,121
54,Chr1,1572885,1573156,1573021,271
54,Chr1,9327760,9328093,9327926,333
54,Chr1,20743913,20744364,20744139,451
54,Chr1,27597772,27598025,27597898,253
54,Chr2,493537,494756,494147,1219
54,Chr2,8431290,8434110,8432700,2820
54,Chr2,17073343,17073852,17073597,509
54,Chr2,17725175,17726371,17725773,1196
54,Chr3,8641648,8642577,8642112,929
54,Chr4,11547014,11548102,11547558,1088
54,Chr5,5301014,5301321,5301168,307
54,Chr5,8146241,8146842,8146541,601
54,Chr5,17734614,17736160,17735387,1546
55,Chr1,450466,452718,451592,2252
55,Chr1,3443575,3445192,3444383,1617
55,Chr1,9458722,9458728,9458725,6
55,Chr1,9926182,9926518,9926350,336
55,Chr1,20688042,20689856,20688949,1814
55,Chr1,24255636,24255762,24255699,126
55,Chr2,8470301,8470562,8470431,261
55,Chr3,2305182,2305249,2305216,67
55,Chr3,19139131,19139397,19139264,266
55,Chr4,302100,302639,302370,539
55,Chr4,8881029,8881142,8881085,113
55,Chr4,11443207,11443386,11443297,179
55,Chr5,873739,873796,873767,57
55,Chr5,5140623,5141244,5140933,621
55,Chr5,18022500,18023142,18022821,642
55,Chr5,21390406,21390802,21390604,396
55,Chr5,24646845,24647574,24647209,729
56,Chr1,2431644,2433507,2432576,1863
56,Chr1,7371512,7372064,7371788,552
56,Chr1,10505905,10506456,10506181,551
56,Chr1,29270178,29271451,29270814,1273
56,Chr2,7532127,7532137,7532132,10
56,Chr2,14585791,14586189,14585990,398
56,Chr3,9483391,9484586,9483989,1195
56,Chr3,18789568,18790159,18789864,591
56,Chr3,20255851,20256937,20256394,1086
56,Chr4,14919739,14931665,14925702,11926
56,Chr4,17631412,17631642,17631527,230
56,Chr5,993402,993971,993686,569
56,Chr5,19108730,19108944,19108837,214
56,Chr5,19829674,19829813,19829744,139
56,Chr5,23087131,23088377,23087754,1246
56,Chr5,26264665,26264807,26264736,142
57,Chr1,7573696,7574795,7574246,1099
57,Chr1,23247608,23247953,23247780,345
57,Chr2,6776201,6777065,6776633,864
57,Chr2,12423071,12424259,12423665,1188
57,Chr2,17111663,17114508,17113085,2845
57,Chr3,5986863,5989913,5988388,3050
57,Chr3,11083154,11085472,11084313,2318
57,Chr3,22126906,22128563,22127734,1657
57,Chr4,7751962,7753174,7752568,1212
57,Chr4,13617095,13617709,13617402,614
57,Chr5,573007,573176,573091,169
57,Chr5,3050560,3051245,3050902,685
58,Chr1,12455296,12455384,12455340,88
58,Chr1,25568318,25568593,25568456,275
58,Chr1,28362736,28364685,28363710,1949
58,Chr2,15379072,15379811,15379442,739
58,Chr3,3666564,3666727,3666646,163
58,Chr3,10989456,10989978,10989717,522
58,Chr4,9391970,9392400,9392185,430
58,Chr5,17594695,17594794,17594745,99
59,Chr1,2850324,2850395,2850360,71
59,Chr1,9651528,9651672,9651600,144
59,Chr1,26075536,26075628,26075582,92
59,Chr2,1561522,1563204,1562363,1682
59,Chr2,8892656,8892804,8892730,148
59,Chr2,13534152,13538931,13536542,4779
59,Chr2,19013031,19013900,19013465,869
59,Chr3,15354687,15354830,15354759,143
59,Chr3,18974761,18975284,18975023,523
59,Chr4,513530,513647,513588,117
59,Chr4,11628431,11629661,11629046,1230
59,Chr4,14620212,14621248,14620730,1036
59,Chr5,156030,156935,156482,905
59,Chr5,14892128,14892180,14892154,52
60,Chr1,1663996,1665195,1664596,1199
60,Chr1,25220385,25222388,25221387,2003
60,Chr2,11038569,11039681,11039125,1112
60,Chr2,19467608,19468251,19467930,643
60,Chr3,5371646,5372409,5372028,763
60,Chr3,17017054,17017551,17017302,497
60,Chr3,21106561,21109814,21108187,3253
60,Chr4,1236833,1237143,1236988,310
60,Chr4,12264879,12265317,12265098,438
60,Chr4,15929822,15934669,15932246,4847
60,Chr5,1489725,1489923,1489824,198
60,Chr5,7225700,7226239,7225970,539
60,Chr5,15341024,15341094,15341059,70
60,Chr5,21022916,21023447,21023182,531
60,Chr5,21578902,21579558,21579230,656
61,Chr1,1348919,1382716,1365817,33797
61,Chr1,30268389,30269146,30268767,757
61,Chr2,6348955,6349052,6349003,97
61,Chr2,8276841,8281565,8279203,4724
61,Chr2,15663162,15663955,15663558,793
61,Chr3,7157700,7158203,7157952,503
61,Chr3,16819084,16819941,16819512,857
61,Chr3,20374578,20375222,20374900,644
61,Chr4,5370948,5371219,5371084,271
61,Chr4,10973281,10974386,10973833,1105
61,Chr4,17420836,17422425,17421630,1589
61,Chr5,910331,910760,910545,429
61,Chr5,1754033,1755276,1754655,1243
61,Chr5,10486315,10486369,10486342,54
61,Chr5,14090818,14091196,14091007,378
61,Chr5,15632129,15632615,15632372,486
61,Chr5,18010558,18010687,18010622,129
62,Chr1,2348057,2348840,2348449,783
62,Chr1,3720422,3720670,3720546,248
62,Chr1,8557397,8559149,8558273,1752
62,Chr1,11026841,11026859,11026850,18
62,Chr1,17505394,17506136,17505765,742
62,Chr1,19909606,19909814,19909710,208
62,Chr1,22519746,22520552,22520149,806
62,Chr1,23342968,23343129,23343048,161
62,Chr1,24806072,24806341,24806206,269
62,Chr2,6692430,6692586,6692508,156
62,Chr2,18534693,18534778,18534735,85
62,Chr3,4375927,4378346,4377137,2419
62,Chr3,7633566,7633659,7633612,93
62,Chr4,697258,713314,705286,16056
62,Chr4,1388650,1389084,1388867,434
62,Chr4,6381003,6381821,6381412,818
62,Chr4,11741509,11742318,11741913,809
62,Chr5,873408,873522,873465,114
62,Chr5,8049952,8049979,8049966,27
63,Chr1,609077,609132,609105,55
63,Chr1,772034,772303,772168,269
63,Chr1,17479172,17479649,17479410,477
63,Chr1,23829907,23830016,23829961,109
63,Chr1,25959489,25961254,25960371,1765
63,Chr2,6801071,6801370,6801221,299
63,Chr2,11534432,11534493,11534462,61
63,Chr3,4330506,4330740,4330623,234
63,Chr3,8268515,8269837,8269176,1322
63,Chr3,9701805,9701980,9701893,175
63,Chr3,21970543,21971386,21970965,843
63,Chr4,6258844,6259275,6259060,431
63,Chr4,11357585,11357834,11357709,249
63,Chr5,758043,758116,758079,73
63,Chr5,7953200,7953409,7953304,209
63,Chr5,14108510,14109653,14109082,1143
63,Chr5,19135315,19136849,19136082,1534
63,Chr5,25107600,25108047,25107824,447
63,Chr5,26336923,26338137,26337530,1214
64,Chr1,7842859,7843198,7843029,339
64,Chr1,17066606,17067032,17066819,426
64,Chr2,10271945,10272064,10272005,119
64,Chr2,19083808,19084721,19084264,913
64,Chr3,2894456,2897362,2895909,2906
64,Chr3,16107981,16108235,16108108,254
64,Chr4,676859,676946,676903,87
64,Chr4,8323474,8324184,8323829,710
64,Chr4,9929241,9929304,9929273,63
64,Chr5,19763666,19766731,19765198,3065
65,Chr1,1642577,1644172,1643375,1595
65,Chr1,6921220,6921738,6921479,518
65,Chr1,7700049,7700733,7700391,684
65,Chr1,8958719,8958998,8958859,279
65,Chr1,17431950,17432065,17432008,115
65,Chr1,19689774,19690184,19689979,410
65,Chr1,25598126,25599417,25598772,1291
65,Chr1,29327994,29328107,29328050,113
65,Chr2,10770210,10770313,10770262,103
65,Chr2,11222793,11223386,11223089,593
65,Chr2,11246649,11247433,11247041,784
65,Chr2,12656525,12659938,12658231,3413
65,Chr2,16505178,16505562,16505370,384
65,Chr3,2073473,2073809,2073641,336
65,Chr3,19261745,19262224,19261985,479
65,Chr3,19823969,19824828,19824399,859
65,Chr4,6209572,6209747,6209660,175
65,Chr4,11619380,11620461,11619920,1081
65,Chr4,18377959,18380006,18378983,2047
65,Chr5,1540559,1546848,1543703,6289
65,Chr5,13880957,13882391,13881674,1434
65,Chr5,17349084,17349169,17349126,85
65,Chr5,24393705,24394213,24393959,508
66,Chr1,432547,445271,438909,12724
66,Chr1,17599064,17600396,17599730,1332
66,Chr2,1640655,1640902,1640779,247
66,Chr3,2439779,2441096,2440437,1317
66,Chr3,19253406,19253752,19253579,346
66,Chr4,9764337,9764465,9764401,128
66,Chr4,10841235,10841372,10841303,137
66,Chr4,14884709,14885350,14885029,641
66,Chr5,497563,497769,497666,206
66,Chr5,3281217,3281709,3281463,492
66,Chr5,7413709,7417572,7415641,3863
66,Chr5,18218289,18218977,18218633,688
66,Chr5,19439621,19439868,19439745,247
66,Chr5,22637133,22637309,22637221,176
67,Chr1,7844626,7845062,7844844,436
67,Chr1,8339797,8340499,8340148,702
67,Chr2,15390872,15392508,15391690,1636
67,Chr2,17443305,17445044,17444175,1739
67,Chr3,7087820,7089792,7088806,1972
67,Chr3,8556214,8556971,8556592,757
67,Chr3,20742240,20744611,20743426,2371
67,Chr4,173975,175744,174859,1769
67,Chr4,12050305,12052179,12051242,1874
67,Chr4,15434128,15466933,15450530,32805
67,Chr4,16516538,16519593,16518066,3055
67,Chr5,5355739,5357549,5356644,1810
67,Chr5,14090348,14090750,14090549,402
67,Chr5,20070931,20072487,20071709,1556
67,Chr5,26084089,26084724,26084407,635
68,Chr1,129671,129841,129756,170
68,Chr1,8241451,8241453,8241452,2
68,Chr1,8467887,8474049,8470968,6162
68,Chr1,25740666,25742572,25741619,1906
68,Chr2,1130417,1131105,1130761,688
68,Chr2,13371687,13372310,13371999,623
68,Chr2,16757784,16758307,16758046,523
68,Chr3,3155290,3155774,3155532,484
68,Chr3,11905374,11905672,11905523,298
68,Chr3,16615925,16616415,16616170,490
68,Chr3,18798995,18799521,18799258,526
68,Chr3,23173616,23175940,23174778,2324
68,Chr4,992640,999428,996034,6788
68,Chr4,6256117,6256448,6256283,331
68,Chr4,10464699,10464723,10464711,24
68,Chr4,17694271,17695595,17694933,1324
68,Chr5,350384,351703,351044,1319
68,Chr5,9521779,9521901,9521840,122
68,Chr5,16844812,16844937,16844874,125
68,Chr5,19688573,19689808,19689191,1235
68,Chr5,24952831,24954450,24953641,1619
69,Chr1,8164665,8164994,8164829,329
69,Chr1,10152041,10157677,10154859,5636
69,Chr1,25564136,25566857,25565496,2721
69,Chr1,27527255,27527947,27527601,692
69,Chr2,1603420,1603581,1603500,161
69,Chr2,15561500,15562974,15562237,1474
69,Chr3,5023151,5024022,5023587,871
69,Chr3,18510482,18511171,18510826,689
69,Chr3,20698212,20698308,20698260,96
69,Chr3,22719067,22720358,22719713,1291
69,Chr4,15291813,15292495,15292154,682
69,Chr5,7271654,7272646,7272150,992
69,Chr5,22441566,22441845,22441706,279
69,Chr5,25397103,25398385,25397744,1282
70,Chr1,7758705,7758825,7758765,120
70,Chr2,346834,346898,346866,64
70,Chr3,1136394,1136968,1136681,574
70,Chr3,6575993,6576312,6576153,319
70,Chr3,22188768,22189556,22189162,788
70,Chr4,322410,323341,322876,931
70,Chr4,7639140,7646741,7642940,7601
70,Chr4,17815496,17817833,17816664,2337
70,Chr5,1526813,1527668,1527241,855
70,Chr5,18037822,18038599,18038210,777
70,Chr5,24979831,24979932,24979881,101
71,Chr1,8451300,8453387,8452344,2087
71,Chr1,22801969,22807456,22804713,5487
71,Chr1,29436769,29436918,29436843,149
71,Chr2,7946189,7946243,7946216,54
71,Chr2,8641230,8641585,8641408,355
71,Chr2,16028940,16029208,16029074,268
71,Chr3,7522893,7523944,7523419,1051
71,Chr3,19991562,19992725,19992144,1163
71,Chr3,21397021,21398339,21397680,1318
71,Chr4,1308125,1308587,1308356,462
71,Chr4,8080629,8082039,8081334,1410
71,Chr4,9401515,9402386,9401951,871
71,Chr5,14954320,14954377,14954348,57
71,Chr5,15254726,15254959,15254842,233
71,Chr5,26792338,26792526,26792432,188
72,Chr1,13455523,13467263,13461393,11740
72,Chr1,17286412,17287121,17286766,709
72,Chr1,29132554,29133274,29132914,720
72,Chr1,29384374,29384726,29384550,352
72,Chr2,1277221,1278013,1277617,792
72,Chr2,6236750,6236991,6236870,241
72,Chr2,7522997,7523324,7523161,327
72,Chr3,6061904,6062955,6062430,1051
72,Chr3,18640211,18642743,18641477,2532
72,Chr4,369818,370327,370072,509
72,Chr4,6187199,6187325,6187262,126
72,Chr4,9361649,9362138,9361893,489
72,Chr5,2060114,2060238,2060176,124
72,Chr5,8992438,8993152,8992795,714
72,Chr5,19976166,19978226,19977196,2060
72,Chr5,21942681,21943544,21943113,863
73,Chr1,5440691,5441222,5440957,531
73,Chr1,12217364,12217499,12217432,135
73,Chr1,18667093,18667808,18667451,715
73,Chr1,21364986,21365442,21365214,456
73,Chr2,12944830,12946156,12945493,1326
73,Chr2,14464060,14464503,14464282,443
73,Chr3,1517183,1522032,1519607,4849
73,Chr3,2177347,2178009,2177678,662
73,Chr3,9428028,9429212,9428620,1184
73,Chr3,17959391,17960142,17959767,751
73,Chr3,22798606,22798849,22798728,243
73,Chr4,7963141,7963727,7963434,586
73,Chr4,10246334,10246660,10246497,326
73,Chr4,11713368,11713731,11713550,363
73,Chr5,736172,736664,736418,492
73,Chr5,2516059,2516455,2516257,396
73,Chr5,6217904,6218123,6218014,219
73,Chr5,24277734,24277954,24277844,220
74,Chr1,1548440,1549045,1548742,605
74,Chr1,26728982,26729088,26729035,106
74,Chr2,18842308,18842951,18842630,643
74,Chr3,6136394,6136992,6136693,598
74,Chr3,16256997,16282145,16269571,25148
74,Chr3,17568768,17569166,17568967,398
74,Chr3,21468762,21492444,21480603,23682
74,Chr4,316605,316669,316637,64
74,Chr4,7282662,7282733,7282698,71
74,Chr4,10384286,10384599,10384442,313
74,Chr4,17230031,17231366,17230699,1335
74,Chr5,3702333,3704413,3703373,2080
75,Chr1,2665738,2666315,2666026,577
75,Chr1,8100524,8102103,8101314,1579
75,Chr1,25840092,25840998,25840545,906
75,Chr3,335714,336801,336258,1087
75,Chr3,790074,790856,790465,782
75,Chr3,9413896,9414564,9414230,668
75,Chr3,11498182,11499613,11498898,1431
75,Chr4,481349,481470,481409,121
75,Chr5,4811485,4813099,4812292,1614
75,Chr5,9897789,9898226,9898007,437
75,Chr5,17240149,17240203,17240176,54
75,Chr5,26158033,26159933,26158983,1900
76,Chr1,1161746,1162124,1161935,378
76,Chr1,7941006,7941206,7941106,200
76,Chr1,10162386,10162997,10162692,611
76,Chr1,11472910,11473053,11472982,143
76,Chr2,964838,965049,964944,211
76,Chr2,8783251,8783414,8783333,163
76,Chr2,11971374,11972424,11971899,1050
76,Chr2,15299459,15300960,15300209,1501
76,Chr2,18531564,18532242,18531903,678
76,Chr3,186476,186923,186700,447
76,Chr3,7540785,7541231,7541008,446
76,Chr4,1507856,1507877,1507866,21
76,Chr4,6997825,6997996,6997911,171
76,Chr4,10873109,10873572,10873341,463
76,Chr4,14895206,14900825,14898016,5619
76,Chr5,1044331,1044499,1044415,168
76,Chr5,2325505,2325754,2325629,249
76,Chr5,25805380,25805601,25805490,221
76,Chr5,26263723,26263945,26263834,222
77,Chr1,4273900,4275011,4274456,1111
77,Chr1,4286216,4288731,4287474,2515
77,Chr2,7496005,7496328,7496167,323
77,Chr2,12908481,12908653,12908567,172
77,Chr3,384560,384884,384722,324
77,Chr4,8391544,8393184,8392364,1640
77,Chr5,10263726,10264141,10263934,415
77,Chr5,14093137,14093507,14093322,370
77,Chr5,16181371,16181579,16181475,208
77,Chr5,19045913,19045969,19045941,56
77,Chr5,26378935,26379118,26379027,183
78,Chr1,4863468,4864935,4864202,1467
78,Chr1,20167930,20168289,20168110,359
78,Chr1,26365412,26365671,26365542,259
78,Chr2,6900099,6902688,6901393,2589
78,Chr2,7996292,7996798,7996545,506
78,Chr2,10247708,10247940,10247824,232
78,Chr3,22641982,22642111,22642046,129
78,Chr4,749559,755938,752749,6379
78,Chr5,388801,389920,389361,1119
78,Chr5,5228587,5229066,5228827,479
78,Chr5,9552959,9552965,9552962,6
78,Chr5,9936359,9936441,9936400,82
78,Chr5,21291395,21292850,21292123,1455
78,Chr5,25645467,25645956,25645711,489
79,Chr1,2439590,2441778,2440684,2188
79,Chr1,8342908,8343175,8343042,267
79,Chr1,12181579,12181699,12181639,120
79,Chr1,13048122,13048184,13048153,62
79,Chr2,15132956,15133395,15133176,439
79,Chr3,5317704,5317864,5317784,160
79,Chr3,11273605,11273724,11273665,119
79,Chr3,19672465,19672869,19672667,404
79,Chr4,1436547,1437284,1436915,737
79,Chr4,9323534,9323959,9323746,425
79,Chr4,14423068,14424738,14423903,1670
79,Chr4,16520900,16523004,16521952,2104
79,Chr5,812898,813071,812984,173
79,Chr5,1676368,1676449,1676408,81
79,Chr5,7665726,7666119,7665922,393
79,Chr5,16590055,16590219,16590137,164
79,Chr5,21925524,21925577,21925550,53
80,Chr1,4421404,4422486,4421945,1082
80,Chr1,8431542,8432335,8431938,793
80,Chr1,10559469,10559825,10559647,356
80,Chr1,22811520,22811812,22811666,292
80,Chr1,25781424,25782909,25782166,1485
80,Chr1,26564876,26565998,26565437,1122
80,Chr2,13507531,13509535,13508533,2004
80,Chr3,17703335,17704335,17703835,1000
80,Chr3,22090537,22090940,22090739,403
80,Chr4,1377898,1378592,1378245,694
80,Chr5,9425648,9425993,9425820,345
80,Chr5,17772640,17773357,17772998,717
80,Chr5,26027492,26027831,26027662,339
81,Chr1,3745687,3745772,3745729,85
81,Chr1,20342252,20343524,20342888,1272
81,Chr1,26265922,26266058,26265990,136
81,Chr1,29910670,29911838,29911254,1168
81,Chr2,4806175,4806437,4806306,262
81,Chr3,326136,328777,327456,2641
81,Chr3,6354860,6355047,6354954,187
81,Chr3,7156681,7156782,7156731,101
81,Chr4,8455159,8456652,8455905,1493
81,Chr5,8214507,8214813,8214660,306
81,Chr5,8685113,8685931,8685522,818
81,Chr5,14293026,14293216,14293121,190
82,Chr1,9380734,9380965,9380850,231
82,Chr1,19879711,19879914,19879813,203
82,Chr1,21627898,21628024,21627961,126
82,Chr1,30035906,30037148,30036527,1242
82,Chr2,10793497,10794804,10794151,1307
82,Chr2,11504276,11506163,11505220,1887
82,Chr3,11649906,11651107,11650506,1201
82,Chr3,20524515,20524957,20524736,442
82,Chr4,5143504,5144053,5143778,549
82,Chr4,5494879,5495463,5495171,584
82,Chr4,7440684,7440769,7440726,85
82,Chr4,14955969,14958690,14957329,2721
82,Chr4,15738975,15739120,15739047,145
82,Chr5,7978365,7979031,7978698,666
82,Chr5,26122426,26122721,26122574,295
83,Chr1,4598926,4599279,4599102,353
83,Chr1,6017009,6017454,6017231,445
83,Chr1,19904561,19905829,19905195,1268
83,Chr1,29435875,29436063,29435969,188
83,Chr2,9776784,9777179,9776982,395
83,Chr2,18410185,18410898,18410541,713
83,Chr2,19137600,19139832,19138716,2232
83,Chr3,3428305,3428648,3428477,343
83,Chr3,9464414,9465004,9464709,590
83,Chr3,17563117,17563474,17563295,357
83,Chr3,21241444,21241579,21241512,135
83,Chr4,5339092,5339147,5339120,55
83,Chr4,9129223,9129645,9129434,422
83,Chr5,1539692,1540559,1540126,867
83,Chr5,16148700,16149285,16148992,585
84,Chr1,623047,623464,623255,417
84,Chr1,12343804,12346465,12345134,2661
84,Chr1,26773025,26778696,26775861,5671
84,Chr2,15962280,15962892,15962586,612
84,Chr2,16561476,16562639,16562058,1163
84,Chr3,80718,80974,80846,256
84,Chr3,22396096,22396353,22396224,257
84,Chr4,6040077,6040557,6040317,480
84,Chr4,7465037,7465924,7465481,887
84,Chr4,11769291,11769474,11769383,183
84,Chr5,439129,439328,439229,199
84,Chr5,18375462,18375566,18375514,104
84,Chr5,25700522,25700994,25700758,472
85,Chr1,5361770,5362318,5362044,548
85,Chr1,13320847,13321133,13320990,286
85,Chr1,25643816,25644983,25644400,1167
85,Chr2,397738,398681,398210,943
85,Chr2,12124196,12124372,12124284,176
85,Chr3,8607879,8608212,8608045,333
85,Chr3,18433915,18436365,18435140,2450
85,Chr4,412126,412810,412468,684
85,Chr4,8645377,8645593,8645485,216
85,Chr4,18178552,18178971,18178762,419
85,Chr5,1567794,1568466,1568130,672
85,Chr5,7266190,7268151,7267170,1961
85,Chr5,19456719,19456958,19456839,239
85,Chr5,26124867,26125162,26125015,295
86,Chr1,3271467,3272537,3272002,1070
86,Chr1,10139957,10140419,10140188,462
86,Chr2,8369041,8371355,8370198,2314
86,Chr2,10549875,10550704,10550289,829
86,Chr2,19479831,19482385,19481108,2554
86,Chr3,2505730,2507198,2506464,1468
86,Chr3,8712101,8712338,8712219,237
86,Chr3,17690457,17690587,17690522,130
86,Chr4,7213355,7214458,7213907,1103
86,Chr4,12069521,12070079,12069800,558
86,Chr5,14531669,14533319,14532494,1650
87,Chr1,8302939,8303694,8303317,755
87,Chr1,24026753,24026942,24026847,189
87,Chr1,26684976,26686384,26685680,1408
87,Chr2,1602469,1602609,1602539,140
87,Chr2,18960901,18961223,18961062,322
87,Chr3,6023621,6023646,6023633,25
87,Chr3,9983757,9984227,9983992,470
87,Chr3,20603417,20604259,20603838,842
87,Chr4,7368323,7368583,7368453,260
87,Chr4,12995903,12996919,12996411,1016
87,Chr4,13267913,13268310,13268111,397
87,Chr5,1704659,1704886,1704773,227
87,Chr5,9354847,9355425,9355136,578
87,Chr5,15774622,15775145,15774884,523
87,Chr5,21844129,21844171,21844150,42
88,Chr1,2268838,2269191,2269014,353
88,Chr1,8143565,8144068,8143817,503
88,Chr1,13079700,13079789,13079744,89
88,Chr1,18196812,18196934,18196873,122
88,Chr1,21919479,21919852,21919665,373
88,Chr1,25975634,25978107,25976870,2473
88,Chr2,9092522,9092802,9092662,280
88,Chr2,13072214,13072697,13072456,483
88,Chr3,11206344,11206646,11206495,302
88,Chr4,6797695,6798034,6797865,339
88,Chr5,3691453,3692575,3692014,1122
88,Chr5,9666367,9667638,9667003,1271
88,Chr5,13880739,13880890,13880815,151
88,Chr5,14890806,14891993,14891400,1187
88,Chr5,24773688,24774510,24774099,822
89,Chr1,5767473,5768336,5767905,863
89,Chr1,12133297,12133343,12133320,46
89,Chr1,16705420,16705799,16705610,379
89,Chr1,23760969,23761908,23761439,939
89,Chr2,660586,660952,660769,366
89,Chr2,17741640,17742758,17742199,1118
89,Chr3,9711641,9711677,9711659,36
89,Chr3,15658062,15658120,15658091,58
89,Chr3,21862562,21862606,21862584,44
89,Chr4,1006374,1009572,1007973,3198
89,Chr4,5724080,5724682,5724381,602
89,Chr4,8445831,8446278,8446055,447
89,Chr4,8881029,8881142,8881085,113
89,Chr4,11525095,11525159,11525127,64
89,Chr5,1035355,1035532,1035443,177
89,Chr5,18215511,18216191,18215851,680
89,Chr5,19863363,19863434,19863399,71
90,Chr1,7388427,7388694,7388561,267
90,Chr1,8344101,8344436,8344269,335
90,Chr1,20838191,20838245,20838218,54
90,Chr1,24368836,24368843,24368840,7
90,Chr1,28108077,28108613,28108345,536
90,Chr2,9933497,9933981,9933739,484
90,Chr2,11595240,11595792,11595516,552
90,Chr2,12625995,12626731,12626363,736
90,Chr3,4078708,4078728,4078718,20
90,Chr3,9970023,9971356,9970689,1333
90,Chr3,19413370,19413506,19413438,136
90,Chr3,22324128,22331817,22327972,7689
90,Chr4,5149416,5150079,5149748,663
90,Chr4,11907304,11907906,11907605,602
90,Chr4,14881939,14882105,14882022,166
90,Chr5,9518242,9518692,9518467,450
90,Chr5,18766448,18766587,18766518,139
91,Chr1,2624195,2624197,2624196,2
91,Chr1,27171700,27171837,27171768,137
91,Chr2,2446743,2461221,2453982,14478
91,Chr2,8908817,8909266,8909041,449
91,Chr2,12154421,12155437,12154929,1016
91,Chr2,13016742,13017309,13017026,567
91,Chr3,5047482,5047613,5047548,131
91,Chr3,7477552,7479234,7478393,1682
91,Chr3,15668218,15668809,15668514,591
91,Chr3,16921855,16922437,16922146,582
91,Chr4,6816522,6816579,6816550,57
91,Chr4,8297018,8297198,8297108,180
91,Chr4,9349512,9351398,9350455,1886
91,Chr4,12211626,12212056,12211841,430
91,Chr4,18567311,18569661,18568486,2350
91,Chr5,9888316,9888895,9888606,579
91,Chr5,24666149,24666595,24666372,446
92,Chr1,1553245,1553753,1553499,508
92,Chr1,3701934,3703979,3702956,2045
92,Chr1,9976029,9976077,9976053,48
92,Chr1,19908093,19908293,19908193,200
92,Chr1,23765255,23765564,23765409,309
92,Chr1,27529678,27530292,27529985,614
92,Chr2,11640989,11641107,11641048,118
92,Chr3,4979144,4979736,4979440,592
92,Chr3,5929351,5931212,5930281,1861
92,Chr3,16465133,16471595,16468364,6462
92,Chr4,190004,190806,190405,802
92,Chr4,6998656,6999921,6999288,1265
92,Chr4,15195415,15195498,15195457,83
92,Chr4,17913762,17914289,17914026,527
92,Chr5,6991799,6992414,6992107,615
92,Chr5,8311630,8311723,8311676,93
92,Chr5,20411446,20412111,20411778,665
93,Chr1,1591045,1591556,1591301,511
93,Chr1,9996961,9998526,9997743,1565
93,Chr3,9762636,9763143,9762890,507
93,Chr3,16148538,16149212,16148875,674
93,Chr4,8622911,8623095,8623003,184
93,Chr4,11887368,11887532,11887450,164
93,Chr4,17649867,17649927,17649897,60
93,Chr5,8284698,8285737,8285218,1039
93,Chr5,9637955,9638584,9638269,629
93,Chr5,23368612,23369322,23368967,710
94,Chr1,2847808,2849453,2848630,1645
94,Chr1,19095031,19095221,19095126,190
94,Chr2,175195,175875,175535,680
94,Chr2,1025193,1025524,1025359,331
94,Chr2,10562451,10562453,10562452,2
94,Chr2,15997353,15998957,15998155,1604
94,Chr3,17692094,17692524,17692309,430
94,Chr3,19150563,19150775,19150669,212
94,Chr4,412126,412810,412468,684
94,Chr4,7726159,7727207,7726683,1048
94,Chr4,11198533,11198966,11198749,433
94,Chr5,3719797,3720221,3720009,424
94,Chr5,9188429,9188676,9188553,247
95,Chr1,7638527,7639278,7638903,751
95,Chr1,17090120,17090231,17090176,111
95,Chr1,18071121,18071216,18071169,95
95,Chr2,2322945,2323050,2322997,105
95,Chr2,8913372,8913392,8913382,20
95,Chr2,14592996,14593486,14593241,490
95,Chr2,16186578,16188388,16187483,1810
95,Chr3,4102643,4103514,4103079,871
95,Chr3,8592873,8593138,8593005,265
95,Chr3,10540519,10540580,10540549,61
95,Chr3,11270158,11270326,11270242,168
95,Chr3,19592866,19595156,19594011,2290
95,Chr3,20229424,20230316,20229870,892
95,Chr4,8868616,8869750,8869183,1134
95,Chr5,502577,503162,502869,585
95,Chr5,2656477,2657663,2657070,1186
95,Chr5,18029454,18030188,18029821,734
95,Chr5,18890854,18891115,18890984,261
95,Chr5,20099697,20099797,20099747,100
96,Chr1,2625960,2626307,2626134,347
96,Chr1,19974306,19974461,19974384,155
96,Chr1,22396165,22396501,22396333,336
96,Chr2,9293627,9293824,9293725,197
96,Chr3,1776477,1776892,1776685,415
96,Chr3,14948894,14949247,14949070,353
96,Chr3,16109155,16110340,16109747,1185
96,Chr4,13373065,13375926,13374495,2861
96,Chr5,4560332,4561350,4560841,1018
96,Chr5,8240287,8240311,8240299,24
96,Chr5,13937717,13937932,13937825,215
96,Chr5,14709774,14709897,14709836,123
