lib,chrs,start,stop,cos,width
1,Chr1,7699074,7700049,7699562,975
1,Chr1,16133722,16134080,16133901,358
1,Chr1,17855730,17856073,17855902,343
1,Chr1,17886136,17894339,17890238,8203
1,Chr1,19572884,19573575,19573230,691
1,Chr2,19620438,19621921,19621180,1483
1,Chr3,412440,412667,412554,227
1,Chr3,2092440,2092843,2092642,403
1,Chr3,3045063,3045752,3045407,689
1,Chr3,4766835,4768252,4767543,1417
1,Chr3,11150235,11150576,11150405,341
1,Chr4,9675966,9675993,9675980,27
1,Chr5,1871750,1872781,1872266,1031
1,Chr5,3219314,3219948,3219631,634
1,Chr5,8562502,8562863,8562682,361
1,Chr5,22693972,22698593,22696282,4621
1,Chr5,26680762,26681056,26680909,294
10,Chr1,127093,129607,128350,2514
10,Chr1,797322,834960,816141,37638
10,Chr1,4969845,4977190,4973517,7345
10,Chr1,9193208,9193409,9193308,201
10,Chr1,9328636,9328762,9328699,126
10,Chr1,10111215,10111674,10111445,459
10,Chr1,20606644,20615934,20611289,9290
10,Chr1,22302768,22303113,22302940,345
10,Chr1,26768271,26768814,26768543,543
10,Chr1,27631516,27631579,27631548,63
10,Chr1,29757855,29758423,29758139,568
10,Chr2,13904216,13904884,13904550,668
10,Chr2,17831141,17832660,17831901,1519
10,Chr3,1080026,1080056,1080041,30
10,Chr3,2338568,2338598,2338583,30
10,Chr3,6091681,6092215,6091948,534
10,Chr3,12773383,12773875,12773629,492
10,Chr3,14763634,14763733,14763684,99
10,Chr3,21283684,21284956,21284320,1272
10,Chr4,666010,666724,666367,714
10,Chr4,1299426,1299512,1299469,86
10,Chr4,9301200,9301624,9301412,424
10,Chr4,10268265,10268664,10268465,399
10,Chr4,14048227,14048669,14048448,442
10,Chr5,2850965,2856669,2853817,5704
10,Chr5,6443354,6445091,6444222,1737
10,Chr5,19508120,19508311,19508216,191
10,Chr5,24098627,24099069,24098848,442
100,Chr1,1660741,1661017,1660879,276
100,Chr1,6606484,6609022,6607753,2538
100,Chr1,7738102,7739748,7738925,1646
100,Chr1,9439921,9439975,9439948,54
100,Chr1,12702736,12702837,12702786,101
100,Chr1,18253191,18254088,18253639,897
100,Chr1,19046794,19047007,19046900,213
100,Chr1,19908093,19908293,19908193,200
100,Chr1,25984653,25985118,25984885,465
100,Chr1,26670388,26670893,26670640,505
100,Chr1,28870471,28876128,28873299,5657
100,Chr2,655473,660952,658213,5479
100,Chr2,6040064,6040109,6040086,45
100,Chr2,17982103,17983576,17982839,1473
100,Chr3,1384681,1386425,1385553,1744
100,Chr3,4125066,4125870,4125468,804
100,Chr3,18904878,18906236,18905557,1358
100,Chr3,19557061,19557857,19557459,796
100,Chr3,21191341,21191519,21191430,178
100,Chr3,21686505,21686670,21686587,165
100,Chr3,22794519,22795605,22795062,1086
100,Chr4,9836319,9836989,9836654,670
100,Chr4,13777373,13793924,13785649,16551
100,Chr4,14440423,14441324,14440873,901
100,Chr5,3183825,3184215,3184020,390
100,Chr5,15955017,15955084,15955051,67
100,Chr5,22073501,22073560,22073531,59
100,Chr5,25108458,25108591,25108524,133
100,Chr5,26534992,26535057,26535024,65
101,Chr1,3530081,3532233,3531157,2152
101,Chr1,3547515,3547767,3547641,252
101,Chr1,10214424,10214544,10214484,120
101,Chr1,10383225,10383384,10383305,159
101,Chr1,22121288,22122241,22121764,953
101,Chr1,23329116,23329185,23329150,69
101,Chr1,27144326,27145576,27144951,1250
101,Chr1,30240641,30241013,30240827,372
101,Chr2,14996156,14996679,14996418,523
101,Chr2,17146346,17146658,17146502,312
101,Chr3,6520545,6520849,6520697,304
101,Chr3,7784629,7784686,7784657,57
101,Chr3,9498878,9499295,9499086,417
101,Chr4,14441485,14441652,14441569,167
101,Chr5,5473945,5478875,5476410,4930
101,Chr5,8916244,8917381,8916812,1137
101,Chr5,14957040,14957835,14957438,795
101,Chr5,20763392,20764196,20763794,804
102,Chr1,654496,655639,655068,1143
102,Chr1,1175046,1175561,1175304,515
102,Chr1,18368096,18368231,18368164,135
102,Chr1,20414631,20418732,20416681,4101
102,Chr1,23024936,23026167,23025552,1231
102,Chr1,25215951,25216134,25216043,183
102,Chr1,27426586,27426740,27426663,154
102,Chr2,12181439,12182162,12181801,723
102,Chr2,16202992,16203319,16203156,327
102,Chr2,18626181,18627510,18626845,1329
102,Chr3,492990,493700,493345,710
102,Chr3,1483431,1484211,1483821,780
102,Chr3,6250651,6250949,6250800,298
102,Chr3,18752006,18752743,18752374,737
102,Chr3,22165799,22166500,22166149,701
102,Chr4,918540,919246,918893,706
102,Chr5,1533857,1535092,1534475,1235
102,Chr5,6792515,6792628,6792571,113
102,Chr5,17000274,17000781,17000528,507
102,Chr5,17750050,17750663,17750356,613
102,Chr5,20149381,20186431,20167906,37050
102,Chr5,23158346,23165567,23161956,7221
102,Chr5,26535874,26536488,26536181,614
103,Chr1,2155891,2157741,2156816,1850
103,Chr1,7921420,7923672,7922546,2252
103,Chr1,9117065,9117257,9117161,192
103,Chr1,13012852,13033405,13023128,20553
103,Chr1,25959489,25961254,25960371,1765
103,Chr2,16468052,16469330,16468691,1278
103,Chr3,910572,913873,912222,3301
103,Chr3,7505132,7505755,7505444,623
103,Chr3,10122998,10125319,10124158,2321
103,Chr3,17762991,17764225,17763608,1234
103,Chr4,13781526,13793924,13787725,12398
103,Chr5,112284,112375,112330,91
103,Chr5,6817129,6818515,6817822,1386
103,Chr5,13749867,13752856,13751361,2989
104,Chr1,1280288,1282224,1281256,1936
104,Chr1,4779442,4779869,4779656,427
104,Chr1,6621287,6621623,6621455,336
104,Chr1,8432775,8432946,8432861,171
104,Chr1,17393382,17394149,17393766,767
104,Chr1,19046794,19047007,19046900,213
104,Chr1,21057344,21058648,21057996,1304
104,Chr1,22929874,22930472,22930173,598
104,Chr1,24232729,24232741,24232735,12
104,Chr1,24902667,24902763,24902715,96
104,Chr1,28388276,28388448,28388362,172
104,Chr1,29781259,29781648,29781453,389
104,Chr2,548128,548269,548198,141
104,Chr2,8430920,8430928,8430924,8
104,Chr2,11343822,11344137,11343980,315
104,Chr3,3384595,3385318,3384957,723
104,Chr3,6895442,6897234,6896338,1792
104,Chr3,20205067,20205633,20205350,566
104,Chr3,22379304,22379510,22379407,206
104,Chr4,13016196,13016836,13016516,640
104,Chr4,14335330,14345835,14340582,10505
104,Chr5,2099013,2099240,2099127,227
104,Chr5,3651355,3653193,3652274,1838
104,Chr5,4543685,4544288,4543987,603
104,Chr5,4971209,4971306,4971257,97
104,Chr5,6992414,6992759,6992586,345
104,Chr5,7306026,7306811,7306418,785
104,Chr5,16834379,16834584,16834481,205
104,Chr5,23771775,23776310,23774043,4535
104,Chr5,25170510,25170976,25170743,466
105,Chr1,844413,847358,845885,2945
105,Chr1,1559270,1559682,1559476,412
105,Chr1,7145362,7145380,7145371,18
105,Chr1,9730551,9730682,9730617,131
105,Chr1,25877114,25877274,25877194,160
105,Chr2,6810401,6810431,6810416,30
105,Chr2,8725604,8725658,8725631,54
105,Chr2,17130436,17140009,17135222,9573
105,Chr2,17748864,17755511,17752188,6647
105,Chr2,18397367,18397525,18397446,158
105,Chr2,19092333,19094192,19093263,1859
105,Chr3,996634,999447,998040,2813
105,Chr3,5892521,5892657,5892589,136
105,Chr4,1220593,1220784,1220689,191
105,Chr4,9929241,9929304,9929273,63
105,Chr5,2772959,2773336,2773147,377
105,Chr5,23263401,23264078,23263739,677
106,Chr1,5325156,5325572,5325364,416
106,Chr1,7090945,7091829,7091387,884
106,Chr1,18363528,18364180,18363854,652
106,Chr1,18886561,18887823,18887192,1262
106,Chr1,23006515,23006712,23006613,197
106,Chr1,25318917,25319517,25319217,600
106,Chr2,12430587,12430748,12430667,161
106,Chr2,13534152,13538931,13536542,4779
106,Chr2,16366839,16366850,16366845,11
106,Chr2,18030141,18030910,18030525,769
106,Chr3,5025557,5026122,5025839,565
106,Chr3,19299801,19301717,19300759,1916
106,Chr3,21139040,21139046,21139043,6
106,Chr4,9031710,9031906,9031808,196
106,Chr4,11191129,11193607,11192368,2478
106,Chr4,14450966,14451283,14451124,317
106,Chr5,7269200,7269581,7269390,381
106,Chr5,24836116,24836620,24836368,504
107,Chr1,309787,314437,312112,4650
107,Chr1,1185563,1188434,1186999,2871
107,Chr1,3562114,3562592,3562353,478
107,Chr1,12295836,12297201,12296518,1365
107,Chr1,17242645,17244721,17243683,2076
107,Chr1,18807450,18807497,18807474,47
107,Chr1,21908909,21909488,21909199,579
107,Chr1,25816672,25817348,25817010,676
107,Chr1,26641785,26642050,26641917,265
107,Chr1,27362281,27362744,27362513,463
107,Chr1,29112073,29114959,29113516,2886
107,Chr2,8567041,8567182,8567111,141
107,Chr2,10476811,10477396,10477103,585
107,Chr2,12352104,12352353,12352228,249
107,Chr2,19259712,19260777,19260244,1065
107,Chr3,65970,66420,66195,450
107,Chr3,86251,87665,86958,1414
107,Chr3,5135037,5142262,5138649,7225
107,Chr3,8727467,8729144,8728305,1677
107,Chr3,16572871,16573286,16573079,415
107,Chr3,19569143,19569688,19569415,545
107,Chr3,20619143,20619897,20619520,754
107,Chr4,13402896,13403354,13403125,458
107,Chr5,1074971,1075357,1075164,386
107,Chr5,3518854,3520798,3519826,1944
107,Chr5,21028313,21028358,21028335,45
108,Chr1,171626,171664,171645,38
108,Chr1,6624079,6625801,6624940,1722
108,Chr1,9853468,9853541,9853504,73
108,Chr1,11279143,11279672,11279407,529
108,Chr1,18915710,18919175,18917442,3465
108,Chr1,18919208,19007704,18963456,88496
108,Chr1,22303113,22304106,22303609,993
108,Chr1,29644546,29645636,29645091,1090
108,Chr2,8243770,8244781,8244276,1011
108,Chr2,12430857,12430924,12430891,67
108,Chr2,17130436,17140009,17135222,9573
108,Chr2,17582440,17584188,17583314,1748
108,Chr3,7425669,7427184,7426427,1515
108,Chr3,9055437,9057744,9056591,2307
108,Chr3,20020859,20022379,20021619,1520
108,Chr4,508220,508895,508558,675
108,Chr4,13062662,13063152,13062907,490
108,Chr5,322506,323787,323146,1281
108,Chr5,5997335,5997947,5997641,612
108,Chr5,16377623,16378412,16378017,789
108,Chr5,20354664,20355451,20355058,787
108,Chr5,26234087,26234306,26234197,219
109,Chr1,1190703,1191118,1190911,415
109,Chr1,4919579,4921643,4920611,2064
109,Chr1,5428926,5429515,5429220,589
109,Chr1,6859560,6860169,6859864,609
109,Chr1,8341205,8341218,8341211,13
109,Chr1,12021852,12022387,12022120,535
109,Chr1,20397507,20397566,20397537,59
109,Chr1,20948514,20949886,20949200,1372
109,Chr1,28455409,28456198,28455803,789
109,Chr2,1077365,1078278,1077821,913
109,Chr2,12964883,12965006,12964945,123
109,Chr2,18259080,18259112,18259096,32
109,Chr2,19209755,19214504,19212129,4749
109,Chr3,4958574,4959319,4958946,745
109,Chr3,16495765,16496619,16496192,854
109,Chr3,19534725,19536201,19535463,1476
109,Chr3,21747155,21747303,21747229,148
109,Chr3,22465677,22466007,22465842,330
109,Chr4,9557007,9557058,9557033,51
109,Chr4,12957984,12958872,12958428,888
109,Chr4,18083537,18084286,18083911,749
109,Chr5,1038093,1038346,1038219,253
109,Chr5,3297582,3297670,3297626,88
109,Chr5,3907257,3914246,3910751,6989
109,Chr5,4180526,4182813,4181670,2287
109,Chr5,8162956,8163080,8163018,124
109,Chr5,14530678,14531152,14530915,474
109,Chr5,21831466,21839666,21835566,8200
109,Chr5,23912800,23913268,23913034,468
109,Chr5,25621218,25621810,25621514,592
11,Chr1,124467,126609,125538,2142
11,Chr1,1064221,1065037,1064629,816
11,Chr1,1727376,1727824,1727600,448
11,Chr1,3619818,3621441,3620630,1623
11,Chr1,9953210,9954455,9953832,1245
11,Chr1,10944048,10944425,10944236,377
11,Chr1,11797434,11797939,11797686,505
11,Chr1,20606644,20615934,20611289,9290
11,Chr1,23335361,23336386,23335873,1025
11,Chr1,26657058,26657453,26657256,395
11,Chr1,29024447,29024828,29024637,381
11,Chr2,2360867,2361855,2361361,988
11,Chr2,11203182,11204085,11203634,903
11,Chr2,13005061,13011674,13008367,6613
11,Chr2,16952611,16952615,16952613,4
11,Chr2,18576829,18578166,18577497,1337
11,Chr3,9761790,9761973,9761882,183
11,Chr3,16351417,16352976,16352197,1559
11,Chr3,22150993,22153289,22152141,2296
11,Chr3,23353305,23353499,23353402,194
11,Chr4,6520400,6520916,6520658,516
11,Chr4,13694024,13696057,13695040,2033
11,Chr4,14138291,14141707,14139999,3416
11,Chr5,210372,210792,210582,420
11,Chr5,2185923,2186112,2186017,189
11,Chr5,2610152,2610597,2610374,445
11,Chr5,4911474,4911614,4911544,140
11,Chr5,22129020,22129095,22129058,75
11,Chr5,23547788,23548437,23548112,649
11,Chr5,26124867,26125162,26125015,295
110,Chr1,590903,591180,591041,277
110,Chr1,1147537,1148269,1147903,732
110,Chr1,2104388,2104632,2104510,244
110,Chr1,10145799,10146139,10145969,340
110,Chr1,23314585,23314839,23314712,254
110,Chr1,29953078,29957835,29955456,4757
110,Chr2,10988868,10989217,10989042,349
110,Chr2,11599705,11600232,11599969,527
110,Chr2,13899439,13900398,13899919,959
110,Chr2,16495483,16495679,16495581,196
110,Chr3,610774,610831,610802,57
110,Chr3,1705637,1705987,1705812,350
110,Chr3,2906411,2911506,2908959,5095
110,Chr3,4089699,4091586,4090643,1887
110,Chr3,18424115,18424438,18424277,323
110,Chr4,10077511,10077702,10077607,191
110,Chr5,163403,164495,163949,1092
110,Chr5,979385,979440,979413,55
110,Chr5,5575778,5577530,5576654,1752
110,Chr5,9048061,9048205,9048133,144
110,Chr5,19434020,19436572,19435296,2552
110,Chr5,21285536,21286536,21286036,1000
110,Chr5,22181393,22182815,22182104,1422
110,Chr5,22786032,22787102,22786567,1070
111,Chr1,3323366,3354275,3338820,30909
111,Chr1,6589775,6589874,6589825,99
111,Chr1,18415808,18420121,18417964,4313
111,Chr1,20664664,20665666,20665165,1002
111,Chr2,1696398,1696501,1696450,103
111,Chr2,8183407,8183508,8183457,101
111,Chr2,14206006,14206157,14206082,151
111,Chr3,1869804,1870010,1869907,206
111,Chr3,6593502,6604125,6598814,10623
111,Chr4,9324343,9324362,9324353,19
111,Chr4,11971606,11971657,11971632,51
111,Chr4,15054404,15054924,15054664,520
111,Chr4,17371026,17371540,17371283,514
111,Chr4,17846516,17847460,17846988,944
111,Chr5,3845035,3845840,3845437,805
111,Chr5,7306811,7308056,7307433,1245
111,Chr5,19961859,19961881,19961870,22
111,Chr5,25328761,25329598,25329179,837
111,Chr5,25928590,25929443,25929016,853
112,Chr1,5410444,5413204,5411824,2760
112,Chr1,6421010,6422350,6421680,1340
112,Chr1,7989712,7989861,7989786,149
112,Chr1,9487039,9487432,9487235,393
112,Chr1,9950537,9951023,9950780,486
112,Chr1,10739193,10739418,10739305,225
112,Chr1,27950692,27950975,27950834,283
112,Chr1,29645817,29646369,29646093,552
112,Chr2,360673,365116,362895,4443
112,Chr2,7603131,7603248,7603189,117
112,Chr2,7654795,7655470,7655133,675
112,Chr3,185881,186026,185953,145
112,Chr3,2442206,2444719,2443462,2513
112,Chr3,3461507,3461514,3461511,7
112,Chr3,18618364,18618720,18618542,356
112,Chr3,20976514,20976655,20976584,141
112,Chr3,22267325,22268663,22267994,1338
112,Chr4,12994579,12995246,12994913,667
112,Chr5,2617191,2619649,2618420,2458
112,Chr5,3861076,3871424,3866250,10348
112,Chr5,14169194,14169309,14169252,115
112,Chr5,24696098,24707834,24701966,11736
112,Chr5,25217439,25218219,25217829,780
112,Chr5,25942775,25947111,25944943,4336
113,Chr1,4041654,4044777,4043216,3123
113,Chr1,9365235,9365548,9365391,313
113,Chr1,28504651,28511467,28508059,6816
113,Chr1,29007802,29008540,29008171,738
113,Chr2,7047500,7048660,7048080,1160
113,Chr2,12636194,12637338,12636766,1144
113,Chr2,14801991,14822392,14812191,20401
113,Chr3,4593990,4594187,4594088,197
113,Chr3,5580150,5583051,5581600,2901
113,Chr3,10189921,10189945,10189933,24
113,Chr3,19753493,19766365,19759929,12872
113,Chr3,20574392,20574684,20574538,292
113,Chr3,22421186,22421612,22421399,426
113,Chr4,9576626,9577443,9577034,817
113,Chr4,12572562,12573224,12572893,662
113,Chr5,1553846,1556447,1555146,2601
113,Chr5,2279171,2282868,2281019,3697
113,Chr5,3083239,3084000,3083619,761
113,Chr5,4770609,4771128,4770869,519
113,Chr5,9424698,9425154,9424926,456
113,Chr5,19900102,19901768,19900935,1666
113,Chr5,21805297,21806203,21805750,906
113,Chr5,23346776,23347906,23347341,1130
113,Chr5,25242333,25243637,25242985,1304
114,Chr1,20095027,20095702,20095365,675
114,Chr1,20719474,20720211,20719842,737
114,Chr2,822543,823240,822891,697
114,Chr2,1033389,1033624,1033507,235
114,Chr2,11872598,11873176,11872887,578
114,Chr2,19664730,19667652,19666191,2922
114,Chr3,1032558,1033000,1032779,442
114,Chr3,1628451,1630647,1629549,2196
114,Chr3,2944712,2945439,2945076,727
114,Chr3,4982230,4983353,4982792,1123
114,Chr3,11756337,11756677,11756507,340
114,Chr3,18917188,18917420,18917304,232
114,Chr3,20375659,20375871,20375765,212
114,Chr3,22653468,22655672,22654570,2204
114,Chr3,23422714,23423348,23423031,634
114,Chr4,7973644,7973812,7973728,168
114,Chr4,15197253,15197370,15197311,117
114,Chr4,16079739,16080175,16079957,436
114,Chr5,1978624,1978826,1978725,202
114,Chr5,2199595,2199702,2199649,107
114,Chr5,4591517,4591529,4591523,12
114,Chr5,22175635,22176342,22175989,707
114,Chr5,23092117,23092175,23092146,58
114,Chr5,23100287,23119076,23109681,18789
114,Chr5,24141995,24142198,24142097,203
115,Chr1,18403169,18404659,18403914,1490
115,Chr1,21019807,21020502,21020155,695
115,Chr1,23045895,23046520,23046207,625
115,Chr1,28862291,28865764,28864027,3473
115,Chr1,29851919,29853643,29852781,1724
115,Chr1,30300501,30301094,30300797,593
115,Chr2,8167355,8168512,8167933,1157
115,Chr2,10204044,10204548,10204296,504
115,Chr2,11087792,11088851,11088322,1059
115,Chr2,12874038,12874190,12874114,152
115,Chr2,18216531,18216872,18216701,341
115,Chr3,380160,384560,382360,4400
115,Chr3,3687727,3688086,3687907,359
115,Chr3,6135457,6136394,6135925,937
115,Chr3,7112707,7113719,7113213,1012
115,Chr3,8901115,8901196,8901155,81
115,Chr3,10239728,10241220,10240474,1492
115,Chr3,22368743,22369021,22368882,278
115,Chr4,6729553,6729651,6729602,98
115,Chr4,12649438,12650379,12649908,941
115,Chr4,14304676,14304947,14304812,271
115,Chr5,385611,385749,385680,138
115,Chr5,5796212,5796358,5796285,146
115,Chr5,14866511,14868385,14867448,1874
115,Chr5,19693124,19693253,19693188,129
115,Chr5,22460352,22462702,22461527,2350
115,Chr5,23119076,23144398,23131737,25322
116,Chr1,847358,850465,848912,3107
116,Chr1,1469258,1471351,1470304,2093
116,Chr1,22114133,22114287,22114210,154
116,Chr1,24433013,24433670,24433341,657
116,Chr1,28455409,28456198,28455803,789
116,Chr2,8105869,8140037,8122953,34168
116,Chr2,12759755,12760125,12759940,370
116,Chr2,14880929,14884716,14882823,3787
116,Chr2,19509800,19514259,19512030,4459
116,Chr3,338229,339294,338761,1065
116,Chr3,6283099,6283256,6283177,157
116,Chr3,7213724,7214290,7214007,566
116,Chr3,8730780,8732332,8731556,1552
116,Chr3,9292812,9295286,9294049,2474
116,Chr3,9958128,9959240,9958684,1112
116,Chr3,18596347,18596661,18596504,314
116,Chr3,19230189,19230323,19230256,134
116,Chr3,22671897,22673645,22672771,1748
116,Chr3,23285879,23286523,23286201,644
116,Chr4,934940,936145,935542,1205
116,Chr4,14514011,14514654,14514333,643
116,Chr5,2822109,2822183,2822146,74
116,Chr5,3858445,3861076,3859761,2631
116,Chr5,8774995,8775123,8775059,128
116,Chr5,16621433,16621574,16621503,141
116,Chr5,20818233,20819503,20818868,1270
116,Chr5,23411074,23411117,23411096,43
116,Chr5,24388557,24388948,24388753,391
116,Chr5,25431728,25431795,25431762,67
117,Chr1,22898487,22899151,22898819,664
117,Chr1,30273702,30275405,30274554,1703
117,Chr2,9671330,9671628,9671479,298
117,Chr2,12370159,12370995,12370577,836
117,Chr2,15668392,15670842,15669617,2450
117,Chr2,17469586,17471736,17470661,2150
117,Chr3,2221837,2221853,2221845,16
117,Chr3,4217457,4218546,4218001,1089
117,Chr3,18074456,18074975,18074716,519
117,Chr3,20396847,20398415,20397631,1568
117,Chr4,768202,768534,768368,332
117,Chr5,2185923,2186112,2186017,189
117,Chr5,2935997,2938561,2937279,2564
117,Chr5,4148528,4148891,4148710,363
117,Chr5,15432865,15432878,15432871,13
117,Chr5,16943349,16943689,16943519,340
117,Chr5,18017610,18019624,18018617,2014
117,Chr5,19693253,19693491,19693372,238
117,Chr5,24396836,24396926,24396881,90
118,Chr1,3833068,3834348,3833708,1280
118,Chr1,6393794,6393855,6393824,61
118,Chr1,8391285,8391346,8391315,61
118,Chr1,18430897,18431785,18431341,888
118,Chr2,7749605,7749690,7749647,85
118,Chr2,13476273,13476861,13476567,588
118,Chr3,2463167,2463845,2463506,678
118,Chr3,5753885,5754326,5754105,441
118,Chr3,7035629,7040114,7037871,4485
118,Chr3,11100706,11100794,11100750,88
118,Chr3,17921518,17924100,17922809,2582
118,Chr3,21116708,21117492,21117100,784
118,Chr4,291877,292300,292089,423
118,Chr4,308062,308466,308264,404
118,Chr4,5236758,5236821,5236790,63
118,Chr4,10581094,10581446,10581270,352
118,Chr4,18328336,18332236,18330286,3900
118,Chr5,1954911,1956371,1955641,1460
118,Chr5,7117559,7117811,7117685,252
118,Chr5,16273942,16274302,16274122,360
119,Chr1,182057,183623,182840,1566
119,Chr1,1065037,1065532,1065285,495
119,Chr1,4074992,4075678,4075335,686
119,Chr1,6267556,6269656,6268606,2100
119,Chr1,10211457,10212255,10211856,798
119,Chr1,12053761,12061061,12057411,7300
119,Chr1,30293857,30294718,30294287,861
119,Chr2,8532366,8535075,8533720,2709
119,Chr2,10504883,10505005,10504944,122
119,Chr2,13192011,13192090,13192051,79
119,Chr2,15255400,15256128,15255764,728
119,Chr3,6419942,6421145,6420544,1203
119,Chr3,16227545,16230006,16228775,2461
119,Chr3,21608492,21614956,21611724,6464
119,Chr4,621312,621475,621394,163
119,Chr4,6351446,6351503,6351474,57
119,Chr4,8420258,8420268,8420263,10
119,Chr4,12251213,12252253,12251733,1040
119,Chr4,15137482,15138908,15138195,1426
119,Chr4,16701015,16701347,16701181,332
119,Chr5,6953709,6954000,6953855,291
119,Chr5,8358542,8358764,8358653,222
119,Chr5,8945888,8946362,8946125,474
119,Chr5,9500094,9500663,9500378,569
119,Chr5,13589179,13590466,13589823,1287
119,Chr5,14199911,14200974,14200443,1063
119,Chr5,21244854,21250196,21247525,5342
119,Chr5,22574913,22575031,22574972,118
119,Chr5,24389082,24389762,24389422,680
12,Chr1,309787,314437,312112,4650
12,Chr1,968896,986719,977808,17823
12,Chr1,6930712,6932577,6931644,1865
12,Chr1,17899400,17899523,17899462,123
12,Chr1,19043119,19043546,19043333,427
12,Chr1,19125085,19126810,19125947,1725
12,Chr1,20502728,20504185,20503456,1457
12,Chr1,21741369,21741417,21741393,48
12,Chr1,23803153,23803905,23803529,752
12,Chr1,25062883,25063148,25063015,265
12,Chr1,27141778,27142066,27141922,288
12,Chr1,28670601,28724228,28697415,53627
12,Chr2,1405816,1407548,1406682,1732
12,Chr2,2189394,2189513,2189454,119
12,Chr3,242374,242565,242470,191
12,Chr3,5294903,5307479,5301191,12576
12,Chr3,6183544,6183563,6183554,19
12,Chr3,8555008,8555418,8555213,410
12,Chr3,11074910,11074931,11074920,21
12,Chr3,19985447,19985926,19985687,479
12,Chr3,21500319,21500352,21500335,33
12,Chr3,23120487,23132471,23126479,11984
12,Chr4,9727734,9727915,9727824,181
12,Chr4,14360933,14366433,14363683,5500
12,Chr5,84356,89507,86932,5151
12,Chr5,3695895,3696035,3695965,140
12,Chr5,5546722,5559677,5553200,12955
12,Chr5,8708437,8712629,8710533,4192
12,Chr5,13763627,13768326,13765977,4699
12,Chr5,14890698,14890740,14890719,42
12,Chr5,22925394,22928299,22926846,2905
12,Chr5,23365230,23365470,23365350,240
12,Chr5,26237555,26238097,26237826,542
120,Chr1,858097,986719,922408,128622
120,Chr1,5193668,5193838,5193753,170
120,Chr1,5638876,5639760,5639318,884
120,Chr1,6675366,6675599,6675482,233
120,Chr1,23003078,23004334,23003706,1256
120,Chr1,26253297,26254313,26253805,1016
120,Chr1,27640109,27641790,27640949,1681
120,Chr2,379428,383692,381560,4264
120,Chr2,19152980,19154087,19153534,1107
120,Chr3,425357,425451,425404,94
120,Chr3,1729157,1729429,1729293,272
120,Chr3,2163808,2165742,2164775,1934
120,Chr3,6661154,6668977,6665066,7823
120,Chr3,19637216,19642149,19639682,4933
120,Chr4,393016,394640,393828,1624
120,Chr4,7195196,7196919,7196058,1723
120,Chr4,9384076,9384771,9384424,695
120,Chr5,1381527,1381884,1381705,357
120,Chr5,3511677,3511734,3511705,57
120,Chr5,4116171,4116644,4116407,473
120,Chr5,4526337,4527317,4526827,980
120,Chr5,5063050,5063091,5063070,41
120,Chr5,6317269,6317370,6317319,101
120,Chr5,7553157,7553366,7553261,209
120,Chr5,13226933,13227155,13227044,222
120,Chr5,16797607,16797985,16797796,378
120,Chr5,20723244,20723372,20723308,128
121,Chr1,528348,560551,544450,32203
121,Chr1,6015934,6017009,6016472,1075
121,Chr1,16127228,16127302,16127265,74
121,Chr1,19154177,19154775,19154476,598
121,Chr1,21012923,21014065,21013494,1142
121,Chr1,22840429,22840608,22840519,179
121,Chr1,28182384,28182998,28182691,614
121,Chr2,2177366,2181177,2179272,3811
121,Chr2,8434110,8434699,8434404,589
121,Chr2,9768495,9768852,9768673,357
121,Chr2,11268066,11268139,11268102,73
121,Chr2,18259388,18260460,18259924,1072
121,Chr3,1460881,1461869,1461375,988
121,Chr3,4846355,4846528,4846441,173
121,Chr3,17766204,17766684,17766444,480
121,Chr3,21397021,21398339,21397680,1318
121,Chr4,7077869,7077920,7077895,51
121,Chr4,9333814,9334225,9334020,411
121,Chr4,14432642,14432689,14432666,47
121,Chr5,6326473,6326570,6326521,97
121,Chr5,21559046,21559503,21559274,457
122,Chr1,306462,309787,308124,3325
122,Chr1,1220819,1221161,1220990,342
122,Chr1,8885151,8885484,8885317,333
122,Chr1,11936615,11936873,11936744,258
122,Chr1,24022500,24023326,24022913,826
122,Chr1,27474999,27475915,27475457,916
122,Chr2,2901756,2902055,2901906,299
122,Chr2,5537099,5537529,5537314,430
122,Chr2,8282067,8292448,8287257,10381
122,Chr2,9037756,9037800,9037778,44
122,Chr2,9678442,9678509,9678476,67
122,Chr3,19417659,19417889,19417774,230
122,Chr3,21304477,21304518,21304497,41
122,Chr4,7769719,7769887,7769803,168
122,Chr5,2656336,2656396,2656366,60
122,Chr5,3507002,3509102,3508052,2100
122,Chr5,13521864,13522016,13521940,152
122,Chr5,18230585,18230709,18230647,124
122,Chr5,23095022,23095852,23095437,830
123,Chr1,129841,135853,132847,6012
123,Chr1,1144854,1145010,1144932,156
123,Chr1,6490023,6490120,6490071,97
123,Chr1,10742303,10742448,10742375,145
123,Chr1,11667109,11667833,11667471,724
123,Chr1,19478855,19479387,19479121,532
123,Chr1,20525160,20525598,20525379,438
123,Chr1,25125011,25129852,25127431,4841
123,Chr1,28629054,28629358,28629206,304
123,Chr2,2309628,2312714,2311171,3086
123,Chr2,8732932,8735034,8733983,2102
123,Chr2,13568915,13569030,13568973,115
123,Chr2,19479831,19483106,19481469,3275
123,Chr3,4080936,4081290,4081113,354
123,Chr3,7069040,7083390,7076215,14350
123,Chr3,20144068,20144380,20144224,312
123,Chr4,10792229,10792457,10792343,228
123,Chr4,12257497,12257517,12257507,20
123,Chr4,13441898,13442574,13442236,676
123,Chr4,14007283,14008187,14007735,904
123,Chr4,18020713,18021048,18020881,335
123,Chr5,20064064,20065592,20064828,1528
123,Chr5,21159245,21160307,21159776,1062
123,Chr5,23340709,23343867,23342288,3158
123,Chr5,24436961,24437082,24437021,121
123,Chr5,25228062,25230302,25229182,2240
124,Chr1,2627547,2628718,2628133,1171
124,Chr1,3934448,3938146,3936297,3698
124,Chr1,6087849,6089572,6088711,1723
124,Chr1,8153476,8153607,8153542,131
124,Chr1,10303945,10305286,10304615,1341
124,Chr1,20279286,20283980,20281633,4694
124,Chr1,20838277,20839073,20838675,796
124,Chr1,26535177,26538046,26536611,2869
124,Chr1,28456198,28477388,28466793,21190
124,Chr1,29233222,29233403,29233312,181
124,Chr2,9853457,9853556,9853507,99
124,Chr2,12771680,12772640,12772160,960
124,Chr2,13624688,13624850,13624769,162
124,Chr2,13781008,13781317,13781162,309
124,Chr3,2364072,2364347,2364210,275
124,Chr3,4681285,4681508,4681397,223
124,Chr3,5830132,5834812,5832472,4680
124,Chr3,15708341,15709056,15708699,715
124,Chr3,17523784,17525706,17524745,1922
124,Chr3,18222155,18222562,18222359,407
124,Chr4,6096802,6098440,6097621,1638
124,Chr4,18490994,18491440,18491217,446
124,Chr5,294116,294212,294164,96
124,Chr5,1028904,1029389,1029146,485
124,Chr5,5392510,5392834,5392672,324
124,Chr5,14120510,14120636,14120573,126
124,Chr5,22083860,22084018,22083939,158
124,Chr5,26228736,26229417,26229076,681
125,Chr1,1022802,1064221,1043512,41419
125,Chr1,9350115,9351144,9350629,1029
125,Chr1,16417601,16424371,16420986,6770
125,Chr1,28629358,28630364,28629861,1006
125,Chr1,29748117,29749252,29748685,1135
125,Chr2,8052093,8052272,8052183,179
125,Chr2,13975947,13979309,13977628,3362
125,Chr2,14728458,14730392,14729425,1934
125,Chr2,15276628,15278555,15277592,1927
125,Chr3,326136,328777,327456,2641
125,Chr3,1790230,1791279,1790754,1049
125,Chr3,2208629,2211525,2210077,2896
125,Chr3,4290406,4291341,4290874,935
125,Chr3,6948680,6970532,6959606,21852
125,Chr3,18300617,18300666,18300641,49
125,Chr3,19932950,19933605,19933278,655
125,Chr3,21060983,21061195,21061089,212
125,Chr3,23356832,23357645,23357238,813
125,Chr4,579323,579649,579486,326
125,Chr4,8396655,8397098,8396877,443
125,Chr4,8879330,8879513,8879422,183
125,Chr4,10944101,10945521,10944811,1420
125,Chr4,13441526,13441655,13441590,129
125,Chr5,17310748,17311463,17311106,715
125,Chr5,24375644,24376164,24375904,520
126,Chr1,9808773,9809441,9809107,668
126,Chr1,17793114,17793605,17793360,491
126,Chr1,20251024,20255999,20253512,4975
126,Chr1,29250386,29251394,29250890,1008
126,Chr1,30271128,30272114,30271621,986
126,Chr3,394565,395693,395129,1128
126,Chr3,15616700,15616786,15616743,86
126,Chr3,20048711,20052968,20050839,4257
126,Chr4,13693512,13693813,13693662,301
126,Chr5,5279271,5279639,5279455,368
126,Chr5,6185739,6186523,6186131,784
126,Chr5,8944727,8945260,8944993,533
126,Chr5,10264320,10264946,10264633,626
126,Chr5,15499810,15499902,15499856,92
126,Chr5,24325218,24326012,24325615,794
126,Chr5,25880741,25881387,25881064,646
127,Chr1,3321813,3321865,3321839,52
127,Chr1,5823605,5824208,5823907,603
127,Chr1,19007704,19007991,19007848,287
127,Chr1,20277355,20279286,20278321,1931
127,Chr1,21993116,21993503,21993310,387
127,Chr1,22496368,22496586,22496477,218
127,Chr1,24228897,24229842,24229369,945
127,Chr1,26466024,26466380,26466202,356
127,Chr1,27045275,27045405,27045340,130
127,Chr1,28062458,28063353,28062906,895
127,Chr1,30243683,30243847,30243765,164
127,Chr2,1846924,1855971,1851448,9047
127,Chr2,6317390,6317702,6317546,312
127,Chr2,10427746,10427953,10427850,207
127,Chr2,13569119,13570198,13569659,1079
127,Chr2,15562750,15562974,15562862,224
127,Chr2,16807182,16809479,16808330,2297
127,Chr3,3654839,3655237,3655038,398
127,Chr3,6567387,6567732,6567559,345
127,Chr3,8003444,8005109,8004276,1665
127,Chr3,9920993,9921328,9921161,335
127,Chr3,10943131,10943178,10943155,47
127,Chr3,21860968,21861021,21860994,53
127,Chr4,5451260,5453025,5452142,1765
127,Chr4,8061043,8062081,8061562,1038
127,Chr4,10058293,10058777,10058535,484
127,Chr4,13367443,13368595,13368019,1152
127,Chr4,15363314,15363443,15363378,129
127,Chr4,16445605,16451265,16448435,5660
127,Chr4,18413480,18414023,18413752,543
127,Chr5,4621919,4622326,4622123,407
127,Chr5,5829587,5829925,5829756,338
127,Chr5,20451057,20451995,20451526,938
127,Chr5,22088174,22088379,22088276,205
127,Chr5,22285039,22285474,22285257,435
127,Chr5,26837280,26839979,26838630,2699
128,Chr1,844413,844417,844415,4
128,Chr1,2996945,2997090,2997017,145
128,Chr1,9276879,9306076,9291477,29197
128,Chr1,11970099,11971670,11970885,1571
128,Chr1,20320371,20321008,20320689,637
128,Chr1,21946321,21947588,21946955,1267
128,Chr1,25594911,25595191,25595051,280
128,Chr2,440642,440644,440643,2
128,Chr2,13740184,13741358,13740771,1174
128,Chr2,16704688,16705075,16704882,387
128,Chr2,19490045,19490700,19490373,655
128,Chr3,71559,72158,71859,599
128,Chr3,549625,554683,552154,5058
128,Chr3,4943573,4943857,4943715,284
128,Chr3,6359894,6360171,6360032,277
128,Chr3,6970532,6986764,6978648,16232
128,Chr3,15909454,15910661,15910058,1207
128,Chr3,18051677,18051940,18051809,263
128,Chr3,18698634,18700283,18699458,1649
128,Chr3,18820009,18820621,18820315,612
128,Chr3,20542748,20544263,20543506,1515
128,Chr3,20902629,20902747,20902688,118
128,Chr3,21721587,21722776,21722181,1189
128,Chr3,22321970,22322299,22322134,329
128,Chr4,10272777,10272850,10272813,73
128,Chr4,11546117,11547014,11546565,897
128,Chr4,12378662,12382189,12380426,3527
128,Chr4,17986389,17986592,17986491,203
128,Chr5,1344131,1344579,1344355,448
128,Chr5,1931025,1932094,1931559,1069
128,Chr5,2704015,2715275,2709645,11260
128,Chr5,4738852,4739430,4739141,578
128,Chr5,4929002,4932430,4930716,3428
128,Chr5,5392834,5393006,5392920,172
128,Chr5,25753761,25754701,25754231,940
128,Chr5,26533566,26533930,26533748,364
129,Chr1,4675948,4690603,4683276,14655
129,Chr1,5054681,5070376,5062529,15695
129,Chr1,6766019,6766100,6766059,81
129,Chr1,7955986,7956515,7956250,529
129,Chr1,19917965,19918573,19918269,608
129,Chr1,29229056,29229112,29229084,56
129,Chr2,2302469,2307373,2304921,4904
129,Chr2,12343857,12344100,12343979,243
129,Chr2,16630799,16632878,16631839,2079
129,Chr3,335510,335661,335586,151
129,Chr3,1317517,1317913,1317715,396
129,Chr3,6668479,6668977,6668728,498
129,Chr3,20970923,20974054,20972489,3131
129,Chr4,1122593,1122814,1122703,221
129,Chr4,10765454,10765891,10765672,437
129,Chr4,11350939,11351704,11351321,765
129,Chr4,12723423,12723958,12723691,535
129,Chr5,37352,38629,37990,1277
129,Chr5,731510,731883,731696,373
129,Chr5,1833955,1848991,1841473,15036
129,Chr5,3044373,3044740,3044557,367
129,Chr5,4955129,4955406,4955267,277
129,Chr5,19705831,19705945,19705888,114
129,Chr5,22879414,22879737,22879576,323
13,Chr1,209015,210319,209667,1304
13,Chr1,2826608,2827042,2826825,434
13,Chr1,8554999,8555359,8555179,360
13,Chr1,9310815,9311044,9310929,229
13,Chr1,19792415,19793231,19792823,816
13,Chr1,23292940,23293356,23293148,416
13,Chr1,27281497,27281707,27281602,210
13,Chr1,29175354,29175918,29175636,564
13,Chr2,8704744,8705073,8704908,329
13,Chr2,10988215,10988868,10988541,653
13,Chr2,14887437,14887516,14887477,79
13,Chr2,15489041,15489061,15489051,20
13,Chr2,16012275,16012835,16012555,560
13,Chr2,17916319,17917120,17916719,801
13,Chr2,19632037,19634418,19633227,2381
13,Chr3,3860113,3860375,3860244,262
13,Chr3,5425966,5426434,5426200,468
13,Chr3,7948466,7948871,7948668,405
13,Chr3,9008354,9009482,9008918,1128
13,Chr3,21854145,21854452,21854299,307
13,Chr3,22901378,22902335,22901856,957
13,Chr3,22979554,22980238,22979896,684
13,Chr4,320251,320507,320379,256
13,Chr4,915633,915689,915661,56
13,Chr4,12990649,12990871,12990760,222
13,Chr5,5982439,5983683,5983061,1244
13,Chr5,7645813,7645837,7645825,24
13,Chr5,8876444,8877138,8876791,694
13,Chr5,16795464,16795640,16795552,176
13,Chr5,20563174,20563355,20563264,181
13,Chr5,22269479,22269912,22269695,433
13,Chr5,23236648,23239378,23238013,2730
13,Chr5,26195443,26196285,26195864,842
13,Chr5,26258172,26258382,26258277,210
130,Chr1,5826410,5828152,5827281,1742
130,Chr1,11971670,11974001,11972836,2331
130,Chr2,8276189,8276841,8276515,652
130,Chr2,14730392,14730661,14730526,269
130,Chr3,2447950,2449619,2448784,1669
130,Chr3,3309945,3313225,3311585,3280
130,Chr3,6080678,6080883,6080780,205
130,Chr3,7083390,7084390,7083890,1000
130,Chr3,20632254,20633150,20632702,896
130,Chr4,8831411,8831624,8831517,213
130,Chr5,398280,398475,398378,195
130,Chr5,13865274,13865992,13865633,718
130,Chr5,24078424,24080054,24079239,1630
130,Chr5,26918159,26918363,26918261,204
131,Chr1,163555,163569,163562,14
131,Chr1,3478765,3480237,3479501,1472
131,Chr1,4244326,4244945,4244636,619
131,Chr1,10374128,10374216,10374172,88
131,Chr1,26003001,26003849,26003425,848
131,Chr1,26555989,26556059,26556024,70
131,Chr1,27683381,27683663,27683522,282
131,Chr2,378796,379428,379112,632
131,Chr2,1172593,1173253,1172923,660
131,Chr2,7869749,7870509,7870129,760
131,Chr2,12126989,12127578,12127283,589
131,Chr2,15981288,15981588,15981438,300
131,Chr2,18017807,18018004,18017905,197
131,Chr3,1836461,1837012,1836737,551
131,Chr3,5568243,5568989,5568616,746
131,Chr3,6813801,6814164,6813983,363
131,Chr3,7538150,7539400,7538775,1250
131,Chr3,19854833,19857095,19855964,2262
131,Chr3,22209849,22210141,22209995,292
131,Chr4,7191331,7192642,7191987,1311
131,Chr4,8468170,8468870,8468520,700
131,Chr4,12455269,12455407,12455338,138
131,Chr5,322434,322506,322470,72
131,Chr5,751149,752764,751957,1615
131,Chr5,1757430,1760580,1759005,3150
131,Chr5,6503831,6507667,6505749,3836
131,Chr5,7002695,7003091,7002893,396
131,Chr5,8283388,8283583,8283486,195
131,Chr5,8996860,8999455,8998158,2595
131,Chr5,19566135,19567624,19566879,1489
131,Chr5,23692100,23692562,23692331,462
131,Chr5,24962615,24962849,24962732,234
132,Chr1,2731409,2731890,2731649,481
132,Chr1,5957690,5957929,5957810,239
132,Chr1,6662604,6663295,6662950,691
132,Chr1,8537354,8537508,8537431,154
132,Chr1,19641521,19641591,19641556,70
132,Chr1,22379524,22382463,22380994,2939
132,Chr1,22409050,22409315,22409182,265
132,Chr1,25740666,25742572,25741619,1906
132,Chr2,298576,298887,298732,311
132,Chr2,17355101,17357427,17356264,2326
132,Chr3,110693,112807,111750,2114
132,Chr3,818223,819834,819029,1611
132,Chr3,5243540,5243611,5243576,71
132,Chr4,9340036,9340235,9340136,199
132,Chr4,18507588,18507910,18507749,322
132,Chr5,3012523,3012978,3012751,455
132,Chr5,3089108,3092466,3090787,3358
132,Chr5,14039326,14040108,14039717,782
132,Chr5,19044293,19044789,19044541,496
132,Chr5,24618195,24618406,24618301,211
133,Chr1,4559612,4559778,4559695,166
133,Chr1,26458638,26458758,26458698,120
133,Chr1,28431833,28433951,28432892,2118
133,Chr2,5509348,5511498,5510423,2150
133,Chr2,17199664,17200171,17199918,507
133,Chr3,21061938,21062284,21062111,346
133,Chr5,1329987,1332190,1331089,2203
133,Chr5,13773083,13773820,13773451,737
133,Chr5,15625383,15626318,15625851,935
133,Chr5,17653035,17654288,17653661,1253
134,Chr1,1280288,1282224,1281256,1936
134,Chr1,4538573,4538828,4538701,255
134,Chr1,5384756,5385101,5384928,345
134,Chr1,8026803,8026936,8026869,133
134,Chr1,9664733,9664899,9664816,166
134,Chr1,11703884,11703975,11703930,91
134,Chr1,24734946,24735036,24734991,90
134,Chr1,26433298,26434062,26433680,764
134,Chr1,27194834,27194892,27194863,58
134,Chr1,29705586,29705625,29705606,39
134,Chr2,160829,161605,161217,776
134,Chr2,756441,757267,756854,826
134,Chr2,1965235,1965920,1965577,685
134,Chr2,17084837,17086526,17085681,1689
134,Chr3,340178,341478,340828,1300
134,Chr3,2837613,2838393,2838003,780
134,Chr3,4089551,4091586,4090569,2035
134,Chr3,4604409,4605030,4604719,621
134,Chr3,7336280,7337569,7336924,1289
134,Chr3,21059701,21059703,21059702,2
134,Chr4,1334248,1334919,1334584,671
134,Chr4,11968427,11969171,11968799,744
134,Chr4,12550236,12551261,12550748,1025
134,Chr4,17860292,17867092,17863692,6800
134,Chr4,18489502,18489907,18489704,405
134,Chr5,3058868,3058931,3058900,63
134,Chr5,5679820,5680373,5680096,553
134,Chr5,6719776,6724211,6721994,4435
134,Chr5,10453184,10453454,10453319,270
134,Chr5,16581465,16581560,16581513,95
135,Chr1,618452,623047,620750,4595
135,Chr1,1198806,1199647,1199226,841
135,Chr1,3090581,3091125,3090853,544
135,Chr1,9487432,9495548,9491490,8116
135,Chr1,10207745,10207845,10207795,100
135,Chr1,10681643,10682685,10682164,1042
135,Chr1,11265161,11265575,11265368,414
135,Chr1,18556950,18557855,18557402,905
135,Chr1,22043218,22043618,22043418,400
135,Chr1,26768271,26768814,26768543,543
135,Chr1,29442281,29442294,29442287,13
135,Chr2,7216509,7216559,7216534,50
135,Chr2,7769344,7769784,7769564,440
135,Chr2,8527580,8527689,8527634,109
135,Chr2,12388645,12389911,12389278,1266
135,Chr2,13734277,13735186,13734731,909
135,Chr2,17878075,17878346,17878211,271
135,Chr2,19010800,19010975,19010888,175
135,Chr3,325470,325752,325611,282
135,Chr3,1086674,1088312,1087493,1638
135,Chr3,3279079,3290911,3284995,11832
135,Chr3,7774653,7775023,7774838,370
135,Chr3,16622513,16624353,16623433,1840
135,Chr3,19828325,19831691,19830008,3366
135,Chr3,21059701,21059703,21059702,2
135,Chr3,21831055,21832166,21831611,1111
135,Chr3,23368154,23368478,23368316,324
135,Chr4,6819258,6820141,6819700,883
135,Chr4,12370813,12371495,12371154,682
135,Chr5,193203,193234,193219,31
135,Chr5,2467579,2468093,2467836,514
135,Chr5,3427568,3427780,3427674,212
135,Chr5,4867476,4868047,4867762,571
135,Chr5,8661718,8661770,8661744,52
135,Chr5,26086213,26086566,26086389,353
136,Chr1,1282224,1282314,1282269,90
136,Chr1,3354275,3361324,3357799,7049
136,Chr1,4039186,4039526,4039356,340
136,Chr1,16484745,16485947,16485346,1202
136,Chr1,22333380,22333755,22333568,375
136,Chr1,30365147,30365406,30365277,259
136,Chr2,8425784,8426323,8426054,539
136,Chr2,18811880,18812187,18812034,307
136,Chr2,19091028,19092333,19091680,1305
136,Chr4,12356309,12357453,12356881,1144
136,Chr4,13939937,13940528,13940233,591
136,Chr5,2986916,2987972,2987444,1056
136,Chr5,21840571,21840825,21840698,254
136,Chr5,26136241,26137266,26136753,1025
137,Chr1,432547,445271,438909,12724
137,Chr1,1175046,1175561,1175304,515
137,Chr1,3016934,3018133,3017534,1199
137,Chr1,6465419,6465490,6465455,71
137,Chr1,6872980,6873470,6873225,490
137,Chr1,19618620,19619045,19618832,425
137,Chr1,24085566,24086749,24086158,1183
137,Chr1,26673254,26674631,26673942,1377
137,Chr1,27609980,27612175,27611078,2195
137,Chr1,28117271,28117537,28117404,266
137,Chr1,29198915,29199476,29199195,561
137,Chr2,7088080,7088107,7088094,27
137,Chr2,9900513,9900658,9900585,145
137,Chr2,10661140,10662216,10661678,1076
137,Chr2,19486174,19486447,19486310,273
137,Chr3,116833,120693,118763,3860
137,Chr3,2417903,2418957,2418430,1054
137,Chr3,2827714,2830269,2828992,2555
137,Chr3,3279079,3290911,3284995,11832
137,Chr3,8061884,8062891,8062388,1007
137,Chr3,21342866,21343401,21343134,535
137,Chr4,10104794,10105708,10105251,914
137,Chr4,13016915,13017414,13017165,499
137,Chr4,17913762,17914289,17914026,527
137,Chr5,1301692,1301805,1301748,113
137,Chr5,4581520,4581806,4581663,286
137,Chr5,5709101,5709790,5709445,689
137,Chr5,18079432,18079478,18079455,46
137,Chr5,19975348,19976166,19975757,818
137,Chr5,21822256,21824533,21823394,2277
137,Chr5,23021417,23022964,23022191,1547
138,Chr1,5072878,5116528,5094703,43650
138,Chr1,18362466,18363120,18362793,654
138,Chr2,13302150,13302244,13302197,94
138,Chr2,18142609,18145029,18143819,2420
138,Chr2,19107034,19108993,19108014,1959
138,Chr3,83191,84250,83721,1059
138,Chr3,4039344,4040351,4039848,1007
138,Chr3,18823793,18824142,18823967,349
138,Chr3,20630405,20630637,20630521,232
138,Chr3,21706682,21706972,21706827,290
138,Chr4,9299327,9299683,9299505,356
138,Chr4,11890771,11891303,11891037,532
138,Chr5,873853,873879,873866,26
138,Chr5,2615398,2616325,2615862,927
138,Chr5,21428967,21429208,21429087,241
138,Chr5,22923481,22923672,22923577,191
138,Chr5,24468737,24469574,24469155,837
139,Chr1,210319,266254,238287,55935
139,Chr1,10714445,10721351,10717898,6906
139,Chr1,26019050,26019383,26019216,333
139,Chr2,7083174,7084322,7083748,1148
139,Chr2,9516312,9518183,9517248,1871
139,Chr2,15072605,15074999,15073802,2394
139,Chr2,19460557,19467282,19463919,6725
139,Chr3,85951,86251,86101,300
139,Chr3,2377372,2378493,2377932,1121
139,Chr3,6421145,6422714,6421929,1569
139,Chr3,19586837,19586904,19586871,67
139,Chr3,20978347,20989147,20983747,10800
139,Chr4,149473,149827,149650,354
139,Chr4,6360181,6360391,6360286,210
139,Chr4,8505063,8505840,8505451,777
139,Chr4,13018025,13020031,13019028,2006
139,Chr5,4651896,4652075,4651986,179
14,Chr1,2095893,2100197,2098045,4304
14,Chr1,23945282,23945551,23945416,269
14,Chr2,16539696,16539806,16539751,110
14,Chr2,18216876,18228405,18222640,11529
14,Chr2,19007678,19007789,19007734,111
14,Chr3,369780,370049,369914,269
14,Chr3,8229124,8229135,8229130,11
14,Chr3,17220069,17220476,17220273,407
14,Chr3,18006550,18006825,18006688,275
14,Chr4,8460401,8460941,8460671,540
14,Chr5,1753947,1754033,1753990,86
140,Chr1,1105328,1105667,1105498,339
140,Chr1,2336149,2336216,2336183,67
140,Chr1,2850324,2850395,2850360,71
140,Chr1,7029982,7031525,7030754,1543
140,Chr1,10364133,10364960,10364547,827
140,Chr1,22629771,22630588,22630179,817
140,Chr1,29779541,29779642,29779591,101
140,Chr3,4909913,4911039,4910476,1126
140,Chr3,18425146,18425327,18425236,181
140,Chr3,20549031,20550084,20549557,1053
140,Chr4,460764,460813,460788,49
140,Chr4,6811382,6811492,6811437,110
140,Chr4,12349419,12349773,12349596,354
140,Chr5,124706,125339,125022,633
140,Chr5,6822789,6823552,6823171,763
140,Chr5,7127855,7128405,7128130,550
140,Chr5,15404784,15405681,15405232,897
140,Chr5,18517542,18520256,18518899,2714
141,Chr1,5348542,5348821,5348682,279
141,Chr1,7045933,7046633,7046283,700
141,Chr1,8349706,8350659,8350182,953
141,Chr1,21242418,21242703,21242560,285
141,Chr1,25322931,25324205,25323568,1274
141,Chr2,18440051,18440259,18440155,208
141,Chr3,15784011,15784188,15784099,177
141,Chr4,410561,412126,411343,1565
141,Chr4,1023562,1024845,1024204,1283
141,Chr5,1377230,1377842,1377536,612
141,Chr5,1929587,1930579,1930083,992
141,Chr5,9034693,9035221,9034957,528
141,Chr5,19896704,19899080,19897892,2376
142,Chr1,5312019,5312927,5312473,908
142,Chr1,5973412,5973692,5973552,280
142,Chr1,7707174,7708394,7707784,1220
142,Chr1,9453979,9454815,9454397,836
142,Chr1,10206800,10206923,10206862,123
142,Chr1,11599352,11599849,11599600,497
142,Chr1,17172262,17174436,17173349,2174
142,Chr2,14086052,14086442,14086247,390
142,Chr2,18454438,18454547,18454492,109
142,Chr2,18940214,18940398,18940306,184
142,Chr3,26138,27414,26776,1276
142,Chr3,670898,671995,671446,1097
142,Chr3,19655093,19655485,19655289,392
142,Chr5,6158107,6158888,6158497,781
142,Chr5,7896144,7898791,7897468,2647
142,Chr5,23838214,23838528,23838371,314
142,Chr5,26234473,26235097,26234785,624
143,Chr1,1817775,1819235,1818505,1460
143,Chr1,9829352,9829848,9829600,496
143,Chr1,11884144,11902127,11893136,17983
143,Chr1,19789214,19789806,19789510,592
143,Chr1,27851192,27851261,27851226,69
143,Chr1,29135651,29136083,29135867,432
143,Chr2,14896496,14899664,14898080,3168
143,Chr2,15508140,15509961,15509050,1821
143,Chr2,19603306,19604696,19604001,1390
143,Chr3,61211,63056,62133,1845
143,Chr3,2463845,2464533,2464189,688
143,Chr3,10067675,10069974,10068825,2299
143,Chr3,17857359,17857387,17857373,28
143,Chr4,7858357,7860500,7859429,2143
143,Chr4,11972404,11972753,11972578,349
143,Chr4,18573554,18573716,18573635,162
143,Chr5,3509307,3510081,3509694,774
143,Chr5,4287300,4287431,4287366,131
143,Chr5,5073133,5122196,5097665,49063
143,Chr5,22862564,22862780,22862672,216
143,Chr5,24859086,24861802,24860444,2716
143,Chr5,24929817,24930135,24929976,318
143,Chr5,26562171,26562645,26562408,474
144,Chr1,993410,1022802,1008106,29392
144,Chr1,2709500,2712443,2710972,2943
144,Chr1,3324508,3324906,3324707,398
144,Chr1,6480956,6481188,6481072,232
144,Chr1,11971670,11974001,11972836,2331
144,Chr1,24838205,24838713,24838459,508
144,Chr1,26554468,26554786,26554627,318
144,Chr2,6649481,6650670,6650075,1189
144,Chr2,9162998,9163589,9163294,591
144,Chr2,10158620,10160538,10159579,1918
144,Chr2,11889590,11890003,11889796,413
144,Chr2,15095734,15095941,15095838,207
144,Chr2,19573426,19573963,19573694,537
144,Chr4,88852,88983,88918,131
144,Chr4,11386019,11386304,11386161,285
144,Chr4,18206405,18208163,18207284,1758
144,Chr4,18465920,18466563,18466242,643
144,Chr5,172553,173733,173143,1180
144,Chr5,2628654,2630032,2629343,1378
144,Chr5,5526979,5536093,5531536,9114
144,Chr5,14239651,14240145,14239898,494
144,Chr5,20875486,20876387,20875936,901
144,Chr5,24069812,24070030,24069921,218
145,Chr1,126609,127093,126851,484
145,Chr1,1310038,1382716,1346377,72678
145,Chr1,2870937,2871042,2870989,105
145,Chr1,3670220,3670354,3670287,134
145,Chr1,6449908,6450216,6450062,308
145,Chr1,18856482,18856886,18856684,404
145,Chr1,20175137,20176520,20175829,1383
145,Chr1,21569456,21569822,21569639,366
145,Chr1,24647721,24647772,24647747,51
145,Chr1,25487427,25497948,25492687,10521
145,Chr1,28441219,28441659,28441439,440
145,Chr1,29242615,29242857,29242736,242
145,Chr2,8431290,8434110,8432700,2820
145,Chr2,16369471,16371836,16370653,2365
145,Chr2,18169172,18170309,18169740,1137
145,Chr3,3951385,3953125,3952255,1740
145,Chr3,9975114,9975303,9975208,189
145,Chr3,20488829,20489041,20488935,212
145,Chr3,22789228,22789801,22789514,573
145,Chr3,22991606,22992146,22991876,540
145,Chr4,6817855,6819258,6818557,1403
145,Chr4,11655212,11655263,11655238,51
145,Chr4,13976116,13977090,13976603,974
145,Chr5,5747697,5749086,5748391,1389
145,Chr5,9045619,9046830,9046225,1211
145,Chr5,16942905,16943203,16943054,298
145,Chr5,23098340,23100287,23099314,1947
145,Chr5,24700114,24707834,24703974,7720
145,Chr5,25937178,25938696,25937937,1518
146,Chr1,1022802,1064221,1043512,41419
146,Chr1,2762123,2762352,2762237,229
146,Chr1,4610331,4610498,4610415,167
146,Chr1,9969401,9969414,9969407,13
146,Chr1,30246586,30247151,30246868,565
146,Chr2,10827974,10828145,10828060,171
146,Chr2,15345720,15345812,15345766,92
146,Chr2,17827462,17827499,17827480,37
146,Chr3,1355404,1355640,1355522,236
146,Chr3,2001551,2002527,2002039,976
146,Chr3,3666785,3668118,3667451,1333
146,Chr3,6762924,6763359,6763142,435
146,Chr3,20940851,20941899,20941375,1048
146,Chr4,18317215,18317361,18317288,146
146,Chr5,3341166,3341364,3341265,198
146,Chr5,4039203,4039846,4039525,643
146,Chr5,4617594,4617721,4617658,127
146,Chr5,6832755,6833157,6832956,402
146,Chr5,14120413,14120510,14120461,97
146,Chr5,19222397,19225155,19223776,2758
146,Chr5,21047610,21047851,21047730,241
146,Chr5,26688668,26689017,26688842,349
147,Chr1,1223092,1223605,1223348,513
147,Chr1,7997201,7997704,7997453,503
147,Chr1,9634892,9635117,9635004,225
147,Chr1,20179885,20179967,20179926,82
147,Chr2,6293373,6293487,6293430,114
147,Chr2,7122829,7122964,7122897,135
147,Chr2,8721455,8723123,8722289,1668
147,Chr2,9249552,9250261,9249906,709
147,Chr2,10910743,10910901,10910822,158
147,Chr2,12757390,12757764,12757577,374
147,Chr2,19020654,19020676,19020665,22
147,Chr3,547787,549625,548706,1838
147,Chr3,1284951,1285070,1285011,119
147,Chr3,2878462,2878943,2878702,481
147,Chr3,3279079,3290911,3284995,11832
147,Chr3,5541430,5543354,5542392,1924
147,Chr3,7835758,7837626,7836692,1868
147,Chr3,8947588,8949375,8948482,1787
147,Chr4,12501355,12505974,12503665,4619
147,Chr4,13393308,13393433,13393370,125
147,Chr5,439427,439569,439498,142
147,Chr5,905864,907940,906902,2076
147,Chr5,3270661,3270856,3270759,195
147,Chr5,6516300,6516525,6516412,225
147,Chr5,7936149,7936185,7936167,36
147,Chr5,8609103,8609685,8609394,582
147,Chr5,13879924,13880021,13879972,97
147,Chr5,18532472,18532559,18532516,87
147,Chr5,20278113,20278325,20278219,212
147,Chr5,23236099,23236306,23236203,207
147,Chr5,24468737,24469574,24469155,837
147,Chr5,25587322,25587464,25587393,142
148,Chr1,432021,432547,432284,526
148,Chr1,4842251,4850961,4846606,8710
148,Chr1,8438273,8438310,8438291,37
148,Chr1,10274000,10275459,10274730,1459
148,Chr1,20411971,20414631,20413301,2660
148,Chr1,21122096,21122213,21122154,117
148,Chr1,25054996,25055539,25055268,543
148,Chr1,27305144,27306451,27305798,1307
148,Chr2,1156680,1159137,1157908,2457
148,Chr2,7457476,7463185,7460330,5709
148,Chr2,10052848,10053286,10053067,438
148,Chr2,10308968,10309058,10309013,90
148,Chr2,11975015,11976099,11975557,1084
148,Chr2,16732575,16734112,16733343,1537
148,Chr3,618897,619096,618997,199
148,Chr3,1141776,1142354,1142065,578
148,Chr3,2923455,2923690,2923573,235
148,Chr3,3585416,3586492,3585954,1076
148,Chr3,4146647,4150595,4148621,3948
148,Chr3,7361705,7361987,7361846,282
148,Chr3,19850716,19852471,19851594,1755
148,Chr3,20637349,20637843,20637596,494
148,Chr3,20891973,20892096,20892035,123
148,Chr4,9856076,9858452,9857264,2376
148,Chr4,10776662,10776998,10776830,336
148,Chr4,11427676,11428055,11427866,379
148,Chr4,12843920,12845723,12844822,1803
148,Chr4,14004051,14004290,14004171,239
148,Chr4,16293712,16294941,16294326,1229
148,Chr4,17229322,17230031,17229676,709
148,Chr4,17846516,17847460,17846988,944
148,Chr5,752764,754100,753432,1336
148,Chr5,1216615,1218213,1217414,1598
148,Chr5,8113122,8123127,8118124,10005
148,Chr5,8833306,8833422,8833364,116
148,Chr5,13687121,13687336,13687229,215
148,Chr5,15981173,15981858,15981515,685
148,Chr5,19389624,19389673,19389648,49
148,Chr5,19806818,19812038,19809428,5220
148,Chr5,21152467,21152761,21152614,294
148,Chr5,26894934,26896302,26895618,1368
149,Chr1,2279907,2283085,2281496,3178
149,Chr1,4027386,4028320,4027853,934
149,Chr1,9065267,9074295,9069781,9028
149,Chr1,10079052,10081934,10080493,2882
149,Chr1,20345148,20350818,20347983,5670
149,Chr1,28148010,28148400,28148205,390
149,Chr1,28624015,28625861,28624938,1846
149,Chr1,29130288,29131050,29130669,762
149,Chr2,7631747,7632027,7631887,280
149,Chr2,8097440,8097905,8097672,465
149,Chr2,14798673,14799634,14799153,961
149,Chr2,15653945,15660078,15657011,6133
149,Chr2,16436320,16437590,16436955,1270
149,Chr2,17917464,17918736,17918100,1272
149,Chr2,18405324,18405447,18405386,123
149,Chr3,358363,359399,358881,1036
149,Chr3,3013021,3018735,3015878,5714
149,Chr3,5746059,5746308,5746183,249
149,Chr3,5892521,5892657,5892589,136
149,Chr3,7067008,7067021,7067014,13
149,Chr3,8983939,8984193,8984066,254
149,Chr3,19991562,19992725,19992144,1163
149,Chr4,11437456,11438827,11438142,1371
149,Chr4,14128204,14129096,14128650,892
149,Chr5,4906008,4906326,4906167,318
149,Chr5,24757637,24757860,24757749,223
15,Chr1,6326988,6328544,6327766,1556
15,Chr1,6795151,6795914,6795533,763
15,Chr1,26652019,26654289,26653154,2270
15,Chr1,28932526,28934610,28933568,2084
15,Chr1,30311048,30312662,30311855,1614
15,Chr2,8294805,8294863,8294834,58
15,Chr2,10686317,10686911,10686614,594
15,Chr2,15128515,15128518,15128517,3
15,Chr2,15549041,15549432,15549237,391
15,Chr2,17837541,17837860,17837701,319
15,Chr3,1823699,1824164,1823931,465
15,Chr3,3309638,3309945,3309792,307
15,Chr3,7929647,7930051,7929849,404
15,Chr3,20163855,20163868,20163861,13
15,Chr3,22960712,22961028,22960870,316
15,Chr4,5746060,5746361,5746210,301
15,Chr4,10346841,10350478,10348659,3637
15,Chr4,12767770,12768756,12768263,986
15,Chr5,3502234,3503467,3502850,1233
15,Chr5,4536117,4537769,4536943,1652
15,Chr5,5073133,5122196,5097665,49063
15,Chr5,14913081,14913264,14913173,183
15,Chr5,17907393,17907622,17907507,229
15,Chr5,22787102,22811115,22799108,24013
15,Chr5,26290723,26290910,26290817,187
150,Chr1,6319725,6319798,6319761,73
150,Chr1,10519732,10520078,10519905,346
150,Chr1,12426089,12426703,12426396,614
150,Chr1,18256871,18257623,18257247,752
150,Chr2,220106,220390,220248,284
150,Chr2,14706150,14706633,14706392,483
150,Chr2,15804154,15804887,15804520,733
150,Chr2,17706458,17706916,17706687,458
150,Chr3,906192,906827,906510,635
150,Chr3,6145503,6145746,6145625,243
150,Chr3,6722179,6722894,6722537,715
150,Chr3,8771578,8771724,8771651,146
150,Chr3,21243607,21244630,21244119,1023
150,Chr3,22047347,22049166,22048257,1819
150,Chr4,11743923,11744032,11743977,109
150,Chr5,2850764,2850965,2850864,201
150,Chr5,5238168,5239256,5238712,1088
150,Chr5,10213026,10213372,10213199,346
150,Chr5,23047211,23047559,23047385,348
150,Chr5,24857532,24858928,24858230,1396
150,Chr5,26801404,26802144,26801774,740
151,Chr1,646603,647033,646818,430
151,Chr1,2739242,2741927,2740584,2685
151,Chr1,6471486,6472913,6472200,1427
151,Chr1,6900424,6900723,6900574,299
151,Chr1,9329688,9330734,9330211,1046
151,Chr1,18653396,18657110,18655253,3714
151,Chr1,28379135,28379553,28379344,418
151,Chr2,5666462,5666885,5666674,423
151,Chr2,6354892,6355532,6355212,640
151,Chr2,10145749,10147121,10146435,1372
151,Chr3,6668479,6668977,6668728,498
151,Chr3,21352460,21352798,21352629,338
151,Chr3,23182303,23182354,23182329,51
151,Chr4,7313570,7314377,7313974,807
151,Chr4,9151844,9152696,9152270,852
151,Chr4,9885075,9885172,9885123,97
151,Chr4,13192024,13192378,13192201,354
151,Chr4,13614350,13617095,13615722,2745
151,Chr5,4777208,4777445,4777326,237
151,Chr5,14703883,14704589,14704236,706
151,Chr5,19693491,19693732,19693611,241
151,Chr5,20939994,20941287,20940640,1293
151,Chr5,24973370,24974028,24973699,658
151,Chr5,25919785,25921384,25920585,1599
152,Chr1,1238377,1238774,1238575,397
152,Chr1,4694570,4709570,4702070,15000
152,Chr1,6034859,6034913,6034886,54
152,Chr1,6758087,6758356,6758221,269
152,Chr1,9453979,9454815,9454397,836
152,Chr1,12096455,12096597,12096526,142
152,Chr1,17214036,17214186,17214111,150
152,Chr1,19047601,19047830,19047715,229
152,Chr1,19204546,19205079,19204812,533
152,Chr1,26605721,26606146,26605933,425
152,Chr1,26727473,26728772,26728123,1299
152,Chr1,29360217,29360473,29360345,256
152,Chr2,8583085,8585225,8584155,2140
152,Chr2,10979153,10980396,10979775,1243
152,Chr2,14401323,14401694,14401509,371
152,Chr2,15116112,15116589,15116350,477
152,Chr2,17819388,17821308,17820348,1920
152,Chr2,18911115,18912067,18911591,952
152,Chr2,19200806,19203511,19202158,2705
152,Chr3,545610,547787,546698,2177
152,Chr3,2312158,2313080,2312619,922
152,Chr3,2888386,2889198,2888792,812
152,Chr3,6189395,6190438,6189917,1043
152,Chr3,18902759,18904687,18903723,1928
152,Chr3,20610256,20610554,20610405,298
152,Chr3,22630415,22630587,22630501,172
152,Chr3,23069179,23069690,23069435,511
152,Chr4,89476,89873,89674,397
152,Chr4,6390877,6390931,6390904,54
152,Chr4,12827066,12828850,12827958,1784
152,Chr5,352047,353273,352660,1226
152,Chr5,1738313,1738704,1738509,391
152,Chr5,2619649,2619771,2619710,122
152,Chr5,6129780,6132422,6131101,2642
152,Chr5,16180187,16180710,16180449,523
152,Chr5,17809746,17809851,17809798,105
152,Chr5,19534436,19535822,19535129,1386
152,Chr5,20994614,20995123,20994868,509
152,Chr5,23165567,23214138,23189853,48571
153,Chr1,3443575,3445192,3444383,1617
153,Chr1,5045278,5054681,5049980,9403
153,Chr1,17367241,17367719,17367480,478
153,Chr2,9219017,9219189,9219103,172
153,Chr2,9509298,9510504,9509901,1206
153,Chr2,11581690,11583110,11582400,1420
153,Chr2,15057449,15057790,15057619,341
153,Chr3,22647827,22648295,22648061,468
153,Chr4,1178568,1179500,1179034,932
153,Chr5,4898121,4898783,4898452,662
153,Chr5,7116144,7116257,7116200,113
154,Chr1,1208938,1209662,1209300,724
154,Chr1,2749451,2749635,2749543,184
154,Chr1,6243402,6243466,6243434,64
154,Chr1,6881881,6882081,6881981,200
154,Chr1,7226758,7227405,7227082,647
154,Chr1,9439236,9439300,9439268,64
154,Chr1,10666182,10666254,10666218,72
154,Chr1,18748499,18750407,18749453,1908
154,Chr1,23231370,23232319,23231844,949
154,Chr1,26136357,26136726,26136541,369
154,Chr1,26657453,26658949,26658201,1496
154,Chr1,28589317,28589606,28589461,289
154,Chr1,29873147,29873351,29873249,204
154,Chr1,30282102,30282114,30282108,12
154,Chr2,10309058,10309775,10309416,717
154,Chr2,13636054,13637023,13636538,969
154,Chr2,16582796,16584558,16583677,1762
154,Chr3,9924738,9924819,9924778,81
154,Chr3,18057329,18057765,18057547,436
154,Chr3,21468762,21492444,21480603,23682
154,Chr4,7548692,7549398,7549045,706
154,Chr4,8367636,8369048,8368342,1412
154,Chr4,10162487,10162659,10162573,172
154,Chr4,11219834,11219885,11219860,51
154,Chr4,12881509,12882505,12882007,996
154,Chr4,17992357,17998829,17995593,6472
154,Chr5,118461,118796,118629,335
154,Chr5,734617,734672,734645,55
154,Chr5,1535092,1535742,1535417,650
154,Chr5,4944795,4945797,4945296,1002
154,Chr5,6386556,6386588,6386572,32
154,Chr5,17935437,17935629,17935533,192
155,Chr1,17962066,17962070,17962068,4
155,Chr1,18123795,18123869,18123832,74
155,Chr1,26085291,26088853,26087072,3562
155,Chr1,28631772,28635121,28633446,3349
155,Chr1,30304543,30304689,30304616,146
155,Chr2,5835710,5835811,5835760,101
155,Chr3,94156,95233,94694,1077
155,Chr3,7067042,7069031,7068036,1989
155,Chr3,7539726,7540031,7539878,305
155,Chr3,18672134,18672838,18672486,704
155,Chr3,22902335,22904444,22903389,2109
155,Chr4,11028614,11028850,11028732,236
155,Chr4,12346027,12346289,12346158,262
155,Chr5,7623903,7624183,7624043,280
155,Chr5,14231020,14231984,14231502,964
155,Chr5,17645641,17645876,17645759,235
155,Chr5,24708623,24708947,24708785,324
155,Chr5,25410855,25411172,25411013,317
155,Chr5,26254698,26255291,26254994,593
156,Chr1,1820786,1820995,1820890,209
156,Chr1,2706338,2707710,2707024,1372
156,Chr1,3247933,3248173,3248053,240
156,Chr1,4010284,4027386,4018835,17102
156,Chr1,7609940,7609956,7609948,16
156,Chr1,10758874,10762248,10760561,3374
156,Chr1,28732706,28739401,28736054,6695
156,Chr2,12939324,12940265,12939794,941
156,Chr2,18866058,18866264,18866161,206
156,Chr3,5445278,5446678,5445978,1400
156,Chr3,6948692,6970532,6959612,21840
156,Chr3,15616191,15616465,15616328,274
156,Chr3,16743163,16743177,16743170,14
156,Chr3,23005311,23009225,23007268,3914
156,Chr4,8158510,8159533,8159022,1023
156,Chr4,18469062,18469209,18469136,147
156,Chr4,18531527,18531796,18531661,269
156,Chr5,1704886,1705045,1704966,159
156,Chr5,3987166,3987650,3987408,484
156,Chr5,6235180,6235630,6235405,450
156,Chr5,15413068,15413732,15413400,664
156,Chr5,24539690,24541688,24540689,1998
157,Chr1,2964546,2964558,2964552,12
157,Chr1,3313889,3313942,3313915,53
157,Chr1,3891758,3891969,3891864,211
157,Chr1,6281631,6281945,6281788,314
157,Chr1,9185069,9185240,9185155,171
157,Chr1,20187303,20187383,20187343,80
157,Chr1,20740202,20740240,20740221,38
157,Chr1,28745359,28746408,28745883,1049
157,Chr2,7483348,7483709,7483528,361
157,Chr2,12494672,12495810,12495241,1138
157,Chr2,13972736,13973106,13972921,370
157,Chr2,16152442,16152598,16152520,156
157,Chr2,17814036,17818369,17816202,4333
157,Chr2,18273222,18273463,18273342,241
157,Chr2,19432415,19432740,19432577,325
157,Chr3,1347629,1347755,1347692,126
157,Chr3,3415548,3418780,3417164,3232
157,Chr3,6668977,6672200,6670589,3223
157,Chr3,7094035,7094038,7094037,3
157,Chr3,7785159,7787181,7786170,2022
157,Chr3,8985367,8986018,8985693,651
157,Chr3,22888251,22888928,22888589,677
157,Chr4,736727,737253,736990,526
157,Chr4,13838058,13839352,13838705,1294
157,Chr5,5223581,5224993,5224287,1412
157,Chr5,6841984,6842219,6842102,235
157,Chr5,20386313,20386597,20386455,284
157,Chr5,20987418,20988036,20987727,618
157,Chr5,25631376,25634603,25632990,3227
158,Chr1,850465,858097,854281,7632
158,Chr1,6340034,6340931,6340482,897
158,Chr1,9637582,9638546,9638064,964
158,Chr1,23580941,23582661,23581801,1720
158,Chr1,24212959,24213475,24213217,516
158,Chr1,28080129,28080410,28080269,281
158,Chr2,8281565,8282007,8281786,442
158,Chr2,10040061,10040304,10040183,243
158,Chr2,10706355,10706806,10706581,451
158,Chr2,12152037,12152194,12152115,157
158,Chr2,15550504,15552184,15551344,1680
158,Chr2,17141388,17142683,17142036,1295
158,Chr3,727934,728767,728350,833
158,Chr3,2841199,2843850,2842525,2651
158,Chr3,5124565,5135037,5129801,10472
158,Chr3,5963150,5963166,5963158,16
158,Chr3,8483552,8484425,8483988,873
158,Chr3,9567950,9568263,9568106,313
158,Chr3,16239340,16243021,16241180,3681
158,Chr3,18116954,18117018,18116986,64
158,Chr3,22131169,22132902,22132035,1733
158,Chr4,898166,899470,898818,1304
158,Chr4,7245915,7246191,7246053,276
158,Chr4,12499109,12501355,12500232,2246
158,Chr5,686513,688787,687650,2274
158,Chr5,2840553,2847703,2844128,7150
158,Chr5,8840394,8840535,8840464,141
158,Chr5,9905764,9905809,9905786,45
158,Chr5,16054945,16055209,16055077,264
158,Chr5,24476964,24483026,24479995,6062
159,Chr1,1382716,1423007,1402862,40291
159,Chr1,5840234,5840961,5840598,727
159,Chr1,8037794,8039339,8038566,1545
159,Chr1,10450760,10451362,10451061,602
159,Chr1,10943834,10944048,10943941,214
159,Chr1,20236696,20236779,20236738,83
159,Chr1,23031553,23031902,23031727,349
159,Chr1,24523416,24523862,24523639,446
159,Chr1,27966805,27966997,27966901,192
159,Chr1,28370761,28371780,28371271,1019
159,Chr1,29178311,29178585,29178448,274
159,Chr2,11168035,11168827,11168431,792
159,Chr2,14646379,14646445,14646412,66
159,Chr2,15774612,15774764,15774688,152
159,Chr2,19448567,19449074,19448821,507
159,Chr3,2354283,2356562,2355423,2279
159,Chr3,3531657,3533846,3532751,2189
159,Chr3,20519027,20519907,20519467,880
159,Chr4,111808,111911,111860,103
159,Chr4,6221271,6221521,6221396,250
159,Chr4,13505722,13505854,13505788,132
159,Chr4,18244944,18245061,18245002,117
159,Chr5,303424,304476,303950,1052
159,Chr5,18717831,18718071,18717951,240
159,Chr5,19838285,19839941,19839113,1656
159,Chr5,22437219,22437286,22437253,67
159,Chr5,22905481,22905533,22905507,52
16,Chr1,2874876,2875385,2875130,509
16,Chr1,4525406,4526278,4525842,872
16,Chr1,9180073,9180689,9180381,616
16,Chr1,10825285,10826779,10826032,1494
16,Chr1,28148400,28148837,28148618,437
16,Chr2,662776,662778,662777,2
16,Chr2,6609536,6609756,6609646,220
16,Chr2,10775494,10776190,10775842,696
16,Chr2,11288286,11289341,11288814,1055
16,Chr2,12389754,12389911,12389832,157
16,Chr2,14126910,14127286,14127098,376
16,Chr2,17390367,17391845,17391106,1478
16,Chr2,18391296,18391904,18391600,608
16,Chr3,181831,183140,182485,1309
16,Chr3,1792154,1792433,1792294,279
16,Chr3,3334922,3335066,3334994,144
16,Chr3,4533158,4533348,4533253,190
16,Chr3,5902282,5903531,5902906,1249
16,Chr3,7268516,7280992,7274754,12476
16,Chr4,302670,303969,303320,1299
16,Chr4,1242127,1242795,1242461,668
16,Chr4,6717709,6718260,6717985,551
16,Chr4,8874575,8875711,8875143,1136
16,Chr4,18434892,18439230,18437061,4338
16,Chr5,6682252,6684950,6683601,2698
16,Chr5,8133938,8134783,8134360,845
16,Chr5,17925096,17925163,17925130,67
16,Chr5,18766448,18766587,18766518,139
16,Chr5,22608688,22611342,22610015,2654
160,Chr1,1382716,1423007,1402862,40291
160,Chr1,4783467,4783598,4783533,131
160,Chr1,7120370,7120572,7120471,202
160,Chr1,27421315,27426586,27423951,5271
160,Chr1,28030230,28032462,28031346,2232
160,Chr2,17631084,17632068,17631576,984
160,Chr2,19592481,19592811,19592646,330
160,Chr3,3308301,3308562,3308431,261
160,Chr3,19388651,19389045,19388848,394
160,Chr3,22880403,22881771,22881087,1368
160,Chr4,11474576,11474617,11474596,41
160,Chr4,12484912,12485052,12484982,140
160,Chr5,4913335,4913716,4913525,381
160,Chr5,8108995,8110578,8109787,1583
160,Chr5,13707451,13708759,13708105,1308
160,Chr5,16296699,16297290,16296995,591
160,Chr5,24401894,24402021,24401958,127
160,Chr5,24989356,24990230,24989793,874
161,Chr1,6492202,6492265,6492234,63
161,Chr1,8095793,8096108,8095951,315
161,Chr1,16920236,16920883,16920560,647
161,Chr1,17641071,17641753,17641412,682
161,Chr1,23990769,23991097,23990933,328
161,Chr1,27148386,27148768,27148577,382
161,Chr1,27750653,27751093,27750873,440
161,Chr2,539722,540281,540002,559
161,Chr2,8631037,8631169,8631103,132
161,Chr2,11197254,11199080,11198167,1826
161,Chr2,12285997,12286078,12286037,81
161,Chr2,13275378,13277039,13276208,1661
161,Chr3,1994281,1994474,1994377,193
161,Chr3,7259020,7259730,7259375,710
161,Chr3,8287868,8288203,8288036,335
161,Chr3,17135755,17135764,17135759,9
161,Chr3,20613579,20615667,20614623,2088
161,Chr3,21144288,21144905,21144596,617
161,Chr4,530670,531859,531264,1189
161,Chr4,6820141,6820566,6820353,425
161,Chr4,8605447,8606624,8606035,1177
161,Chr4,9788379,9789097,9788738,718
161,Chr4,11877030,11878121,11877576,1091
161,Chr4,13226704,13227755,13227230,1051
161,Chr5,809293,809907,809600,614
161,Chr5,3634722,3637091,3635906,2369
161,Chr5,4944812,4945797,4945304,985
161,Chr5,17256849,17257630,17257239,781
161,Chr5,20212202,20212376,20212289,174
161,Chr5,20901174,20901310,20901242,136
161,Chr5,24438138,24438277,24438208,139
161,Chr5,26285273,26286004,26285639,731
162,Chr1,173162,173531,173346,369
162,Chr1,3838694,3839037,3838866,343
162,Chr1,5304046,5304165,5304106,119
162,Chr1,7202860,7203873,7203366,1013
162,Chr1,10493403,10493901,10493652,498
162,Chr1,19871896,19873401,19872648,1505
162,Chr1,27421315,27426586,27423951,5271
162,Chr2,383692,385597,384644,1905
162,Chr2,10776736,10781842,10779289,5106
162,Chr2,12041578,12104379,12072978,62801
162,Chr2,16745006,16749710,16747358,4704
162,Chr2,18866058,18866264,18866161,206
162,Chr3,1321248,1323800,1322524,2552
162,Chr3,4139143,4141096,4140119,1953
162,Chr3,4623135,4623449,4623292,314
162,Chr3,5294903,5307479,5301191,12576
162,Chr3,8296833,8384577,8340705,87744
162,Chr3,10039680,10041352,10040516,1672
162,Chr3,15825623,15826004,15825813,381
162,Chr3,18225753,18227536,18226645,1783
162,Chr3,20777990,20778206,20778098,216
162,Chr4,958420,958927,958674,507
162,Chr4,1415313,1415801,1415557,488
162,Chr4,11180230,11180264,11180247,34
162,Chr4,12306312,12306531,12306422,219
162,Chr4,12507849,12509296,12508573,1447
162,Chr4,13387499,13388432,13387965,933
162,Chr5,1787276,1787364,1787320,88
162,Chr5,5267320,5268566,5267943,1246
162,Chr5,9388351,9388477,9388414,126
162,Chr5,13708719,13708759,13708739,40
162,Chr5,18010939,18012642,18011791,1703
162,Chr5,20257940,20258010,20257975,70
162,Chr5,26216717,26218455,26217586,1738
163,Chr1,485402,489092,487247,3690
163,Chr1,4055730,4055980,4055855,250
163,Chr1,5508253,5508490,5508371,237
163,Chr1,6579125,6580964,6580045,1839
163,Chr1,9092461,9094151,9093306,1690
163,Chr1,15986009,15986748,15986379,739
163,Chr1,18107739,18108435,18108087,696
163,Chr1,20135840,20136057,20135948,217
163,Chr1,29197089,29198915,29198002,1826
163,Chr1,29762476,29763058,29762767,582
163,Chr2,633563,634631,634097,1068
163,Chr2,8735034,8735752,8735393,718
163,Chr2,9918041,9918157,9918099,116
163,Chr2,10432700,10437717,10435208,5017
163,Chr2,12912169,12912237,12912203,68
163,Chr2,15285877,15286158,15286017,281
163,Chr2,17022005,17023183,17022594,1178
163,Chr2,18484191,18485184,18484687,993
163,Chr3,2894255,2894398,2894327,143
163,Chr3,3389313,3389628,3389471,315
163,Chr3,7450364,7451027,7450696,663
163,Chr3,17691385,17692094,17691739,709
163,Chr3,19580401,19582106,19581253,1705
163,Chr3,20842740,20844604,20843672,1864
163,Chr3,22047798,22049166,22048482,1368
163,Chr4,1320174,1320750,1320462,576
163,Chr4,6870916,6871828,6871372,912
163,Chr4,12810954,12811465,12811210,511
163,Chr5,23358847,23360501,23359674,1654
163,Chr5,23898240,23898374,23898307,134
163,Chr5,24622440,24622507,24622474,67
164,Chr1,3351027,3354275,3352651,3248
164,Chr1,7147761,7152505,7150133,4744
164,Chr1,12503733,12504455,12504094,722
164,Chr1,29590729,29593566,29592147,2837
164,Chr2,18337971,18338059,18338015,88
164,Chr3,2498032,2498037,2498034,5
164,Chr3,22141789,22144362,22143075,2573
164,Chr4,1515200,1515782,1515491,582
164,Chr4,7592757,7592864,7592811,107
164,Chr4,9202144,9202188,9202166,44
164,Chr5,4768672,4770609,4769640,1937
164,Chr5,8862233,8866181,8864207,3948
164,Chr5,14992662,14992831,14992746,169
164,Chr5,16206348,16206585,16206466,237
164,Chr5,25937111,25937178,25937145,67
165,Chr1,3595811,3600937,3598374,5126
165,Chr1,18807327,18807430,18807379,103
165,Chr1,21252174,21255402,21253788,3228
165,Chr1,25487427,25497948,25492687,10521
165,Chr1,27971578,27972939,27972258,1361
165,Chr2,8167355,8168512,8167933,1157
165,Chr2,8691396,8691752,8691574,356
165,Chr2,14968386,14968974,14968680,588
165,Chr2,16201793,16202828,16202311,1035
165,Chr3,39624,40165,39894,541
165,Chr3,6714346,6714671,6714508,325
165,Chr3,8927982,8928408,8928195,426
165,Chr3,18878126,18878241,18878184,115
165,Chr3,21010062,21010268,21010165,206
165,Chr4,8087069,8087362,8087215,293
165,Chr4,10973238,10973253,10973246,15
165,Chr4,13592427,13612527,13602477,20100
165,Chr4,18473109,18473460,18473285,351
165,Chr5,998983,999618,999301,635
165,Chr5,4059678,4060806,4060242,1128
165,Chr5,4720877,4722589,4721733,1712
165,Chr5,13824025,13824528,13824277,503
165,Chr5,16539398,16539521,16539460,123
165,Chr5,17704264,17704384,17704324,120
165,Chr5,25088877,25089122,25088999,245
165,Chr5,25650789,25652484,25651637,1695
165,Chr5,26697632,26698113,26697872,481
166,Chr1,7786459,7787323,7786891,864
166,Chr1,11742585,11747555,11745070,4970
166,Chr1,11970099,11971670,11970885,1571
166,Chr1,19831848,19832145,19831996,297
166,Chr1,26659006,26660269,26659638,1263
166,Chr1,28425345,28425644,28425495,299
166,Chr1,29275484,29276254,29275869,770
166,Chr2,7937236,7937320,7937278,84
166,Chr2,13088971,13089352,13089161,381
166,Chr2,15203637,15209519,15206578,5882
166,Chr2,15468848,15469713,15469280,865
166,Chr2,17248764,17250013,17249388,1249
166,Chr2,18259080,18259388,18259234,308
166,Chr2,19169707,19169811,19169759,104
166,Chr3,2505730,2507198,2506464,1468
166,Chr3,3091898,3094073,3092986,2175
166,Chr3,4602619,4603486,4603053,867
166,Chr3,6668977,6672200,6670589,3223
166,Chr3,8134940,8136201,8135570,1261
166,Chr3,12773875,12773975,12773925,100
166,Chr3,19100851,19103908,19102379,3057
166,Chr3,19766365,19770009,19768187,3644
166,Chr3,20310054,20310466,20310260,412
166,Chr3,21169079,21169754,21169417,675
166,Chr3,21398339,21435092,21416715,36753
166,Chr3,22324128,22331817,22327972,7689
166,Chr3,23317501,23317858,23317679,357
166,Chr4,713286,713314,713300,28
166,Chr4,8509004,8510659,8509832,1655
166,Chr4,10364749,10365037,10364893,288
166,Chr4,11215039,11216256,11215647,1217
166,Chr4,18452618,18453246,18452932,628
166,Chr4,18454520,18454856,18454688,336
166,Chr5,1762648,1762804,1762726,156
166,Chr5,16024609,16025195,16024902,586
166,Chr5,16590219,16591685,16590952,1466
167,Chr1,3247933,3248173,3248053,240
167,Chr1,4894949,4895565,4895257,616
167,Chr1,11111340,11111497,11111418,157
167,Chr1,17801173,17804955,17803064,3782
167,Chr1,18362186,18362466,18362326,280
167,Chr1,19043119,19043546,19043333,427
167,Chr1,24110069,24110436,24110253,367
167,Chr1,28179141,28180936,28180039,1795
167,Chr2,5059886,5066497,5063192,6611
167,Chr2,7143001,7144270,7143635,1269
167,Chr2,16093491,16093896,16093693,405
167,Chr2,17250893,17251303,17251098,410
167,Chr2,18177528,18192909,18185218,15381
167,Chr3,837944,838059,838002,115
167,Chr3,1839488,1839852,1839670,364
167,Chr3,4641080,4642009,4641544,929
167,Chr3,5862280,5863076,5862678,796
167,Chr3,6913983,6914886,6914435,903
167,Chr3,7489862,7491191,7490526,1329
167,Chr3,18402039,18402861,18402450,822
167,Chr3,21626834,21629053,21627944,2219
167,Chr3,23276827,23277674,23277251,847
167,Chr4,9287173,9288153,9287663,980
167,Chr4,10475231,10475465,10475348,234
167,Chr4,14228445,14229208,14228827,763
167,Chr5,2715275,2716246,2715761,971
167,Chr5,4000591,4000867,4000729,276
167,Chr5,5408637,5408656,5408647,19
167,Chr5,16461130,16462966,16462048,1836
167,Chr5,17652642,17652785,17652714,143
167,Chr5,18136406,18136641,18136524,235
167,Chr5,18790298,18791191,18790744,893
167,Chr5,25981568,25981848,25981708,280
167,Chr5,26037603,26037702,26037653,99
168,Chr1,1742481,1742651,1742566,170
168,Chr1,5483312,5483806,5483559,494
168,Chr1,6267235,6267276,6267255,41
168,Chr1,6872476,6872875,6872676,399
168,Chr1,7967085,7967223,7967154,138
168,Chr1,17797325,17801173,17799249,3848
168,Chr1,20724919,20725095,20725007,176
168,Chr1,23945551,23945737,23945644,186
168,Chr1,24448000,24448193,24448096,193
168,Chr1,25877274,25877593,25877434,319
168,Chr1,26731572,26732327,26731950,755
168,Chr2,450531,451793,451162,1262
168,Chr2,11381984,11384216,11383100,2232
168,Chr2,18736334,18736840,18736587,506
168,Chr3,2375828,2376219,2376024,391
168,Chr3,3648864,3649380,3649122,516
168,Chr3,4154747,4155484,4155115,737
168,Chr3,5239186,5243540,5241363,4354
168,Chr3,6740351,6740716,6740533,365
168,Chr3,18808538,18808624,18808581,86
168,Chr3,20586170,20586297,20586234,127
168,Chr3,23213157,23220565,23216861,7408
168,Chr4,14129096,14129731,14129414,635
168,Chr4,18404573,18404873,18404723,300
168,Chr5,2124838,2125050,2124944,212
168,Chr5,4304323,4304869,4304596,546
168,Chr5,8197205,8197219,8197212,14
168,Chr5,8928308,8934394,8931351,6086
168,Chr5,18033139,18033212,18033175,73
168,Chr5,26161634,26163149,26162392,1515
168,Chr5,26627873,26629387,26628630,1514
169,Chr1,771525,771817,771671,292
169,Chr1,3491879,3493900,3492889,2021
169,Chr1,10795454,10796344,10795899,890
169,Chr1,19907527,19908076,19907801,549
169,Chr2,10741824,10741965,10741894,141
169,Chr2,11400105,11400235,11400170,130
169,Chr2,14968974,14969841,14969408,867
169,Chr2,16239904,16240204,16240054,300
169,Chr2,18739505,18740211,18739858,706
169,Chr3,4861347,4862146,4861747,799
169,Chr3,6688365,6696991,6692678,8626
169,Chr3,18959312,18959598,18959455,286
169,Chr3,20406439,20406781,20406610,342
169,Chr4,201567,201574,201571,7
169,Chr4,9678877,9679687,9679282,810
169,Chr5,2775373,2775753,2775563,380
169,Chr5,8123178,8126021,8124600,2843
169,Chr5,10285509,10286505,10286007,996
169,Chr5,19114023,19115775,19114899,1752
169,Chr5,23792149,23792454,23792301,305
169,Chr5,25513597,25513822,25513709,225
17,Chr1,445271,446882,446077,1611
17,Chr1,8728014,8728140,8728077,126
17,Chr1,10140419,10140485,10140452,66
17,Chr1,18647355,18647573,18647464,218
17,Chr1,19822074,19823682,19822878,1608
17,Chr1,21249807,21250036,21249921,229
17,Chr1,24110069,24110436,24110253,367
17,Chr1,26079116,26079181,26079148,65
17,Chr2,356361,356583,356472,222
17,Chr3,303169,304406,303787,1237
17,Chr3,4311744,4312670,4312207,926
17,Chr3,6274007,6276158,6275083,2151
17,Chr3,7288153,7288248,7288201,95
17,Chr3,18907905,18908687,18908296,782
17,Chr4,325483,325641,325562,158
17,Chr4,8994413,8994635,8994524,222
17,Chr4,9770756,9771685,9771220,929
17,Chr4,12564426,12564499,12564462,73
17,Chr5,4600754,4601182,4600968,428
17,Chr5,5710751,5712376,5711563,1625
17,Chr5,20564381,20630854,20597617,66473
17,Chr5,23088377,23089425,23088901,1048
17,Chr5,26598281,26599229,26598755,948
17,Chr5,26751139,26751258,26751199,119
170,Chr1,292574,292666,292620,92
170,Chr1,4034601,4036434,4035517,1833
170,Chr1,8533049,8533147,8533098,98
170,Chr1,20588582,20589665,20589124,1083
170,Chr1,24053248,24053746,24053497,498
170,Chr2,14377074,14377113,14377094,39
170,Chr2,14538349,14541408,14539879,3059
170,Chr2,18606592,18607883,18607238,1291
170,Chr3,4982018,4982030,4982024,12
170,Chr3,6359239,6359472,6359355,233
170,Chr3,10249734,10249905,10249820,171
170,Chr3,19869365,19869913,19869639,548
170,Chr4,9380468,9381839,9381154,1371
170,Chr5,1283057,1283271,1283164,214
170,Chr5,4166040,4167752,4166896,1712
170,Chr5,8365209,8367481,8366345,2272
170,Chr5,20096612,20096864,20096738,252
170,Chr5,20561914,20562085,20562000,171
170,Chr5,24642882,24643891,24643386,1009
170,Chr5,26807984,26809304,26808644,1320
171,Chr1,850465,858097,854281,7632
171,Chr1,5070376,5072878,5071627,2502
171,Chr1,6206052,6208555,6207304,2503
171,Chr1,7120572,7121513,7121042,941
171,Chr1,10721351,10721638,10721495,287
171,Chr1,11829589,11829987,11829788,398
171,Chr1,23945551,23945737,23945644,186
171,Chr2,12289886,12290969,12290428,1083
171,Chr2,17635602,17635899,17635750,297
171,Chr2,19479419,19479831,19479625,412
171,Chr3,1018831,1019521,1019176,690
171,Chr3,6838850,6841136,6839993,2286
171,Chr3,9839654,9841282,9840468,1628
171,Chr3,20718992,20719037,20719014,45
171,Chr3,22046652,22046738,22046695,86
171,Chr4,6291862,6292674,6292268,812
171,Chr4,12511384,12512451,12511918,1067
171,Chr4,13204116,13204335,13204226,219
171,Chr5,2864625,2874908,2869767,10283
171,Chr5,4550376,4551470,4550923,1094
171,Chr5,8289822,8290084,8289953,262
171,Chr5,9440095,9440176,9440135,81
171,Chr5,14866511,14868385,14867448,1874
171,Chr5,19231171,19235580,19233375,4409
171,Chr5,20748374,20752809,20750592,4435
171,Chr5,22703671,22704512,22704091,841
171,Chr5,24663909,24664321,24664115,412
171,Chr5,26833923,26834069,26833996,146
172,Chr1,3732728,3733034,3732881,306
172,Chr1,6277859,6277976,6277917,117
172,Chr1,7401897,7403116,7402507,1219
172,Chr1,8036376,8037613,8036994,1237
172,Chr1,18726807,18727993,18727400,1186
172,Chr1,28606556,28607131,28606844,575
172,Chr2,1479167,1479452,1479309,285
172,Chr2,6689043,6689371,6689207,328
172,Chr2,10653831,10655803,10654817,1972
172,Chr2,16796486,16796898,16796692,412
172,Chr2,18169172,18170309,18169740,1137
172,Chr3,1089856,1090679,1090268,823
172,Chr3,6114104,6115052,6114578,948
172,Chr3,9308064,9308296,9308180,232
172,Chr3,11005269,11008782,11007025,3513
172,Chr3,21825952,21826800,21826376,848
172,Chr4,9730209,9731137,9730673,928
172,Chr5,398179,398280,398229,101
172,Chr5,4542764,4543568,4543166,804
172,Chr5,9685244,9685584,9685414,340
172,Chr5,16541544,16541826,16541685,282
172,Chr5,23288042,23288309,23288176,267
172,Chr5,23898875,23899207,23899041,332
173,Chr1,1150961,1153526,1152243,2565
173,Chr1,18466799,18468201,18467500,1402
173,Chr1,24538478,24538854,24538666,376
173,Chr1,28425782,28425813,28425798,31
173,Chr2,1522848,1522931,1522890,83
173,Chr2,8851282,8851966,8851624,684
173,Chr2,11016635,11018094,11017365,1459
173,Chr2,12419551,12419844,12419697,293
173,Chr2,18680432,18683076,18681754,2644
173,Chr3,818223,819834,819029,1611
173,Chr3,3714948,3717750,3716349,2802
173,Chr3,4444826,4452589,4448708,7763
173,Chr3,17084727,17086742,17085735,2015
173,Chr3,19908151,19908365,19908258,214
173,Chr3,20554830,20554910,20554870,80
173,Chr4,7567942,7568900,7568421,958
173,Chr4,14117602,14118000,14117801,398
173,Chr4,14608070,14608536,14608303,466
173,Chr4,17525425,17525642,17525533,217
173,Chr4,18409002,18411144,18410073,2142
173,Chr5,4344916,4346527,4345722,1611
173,Chr5,17537516,17538000,17537758,484
173,Chr5,26028318,26028464,26028391,146
174,Chr1,569887,570157,570022,270
174,Chr1,7636148,7636827,7636488,679
174,Chr1,27189299,27191217,27190258,1918
174,Chr1,28642136,28651893,28647014,9757
174,Chr2,9219440,9220061,9219750,621
174,Chr2,9237339,9237745,9237542,406
174,Chr2,11287514,11288214,11287864,700
174,Chr2,17991797,17995439,17993618,3642
174,Chr3,2645423,2646751,2646087,1328
174,Chr3,9970023,9971356,9970689,1333
174,Chr3,23095138,23095269,23095204,131
174,Chr4,186173,187613,186893,1440
174,Chr4,18049593,18049925,18049759,332
174,Chr5,290493,291448,290971,955
174,Chr5,1901050,1901402,1901226,352
174,Chr5,5004530,5004615,5004572,85
174,Chr5,10300913,10301025,10300969,112
175,Chr1,1070910,1071783,1071346,873
175,Chr1,17119527,17120805,17120166,1278
175,Chr1,19203898,19204102,19204000,204
175,Chr1,25834888,25835236,25835062,348
175,Chr2,7298721,7299017,7298869,296
175,Chr2,8581423,8581758,8581591,335
175,Chr2,15774882,15774969,15774926,87
175,Chr2,17170480,17171407,17170944,927
175,Chr2,17372984,17374328,17373656,1344
175,Chr2,17876819,17877612,17877215,793
175,Chr2,19295616,19298140,19296878,2524
175,Chr3,4635488,4635629,4635558,141
175,Chr3,18114416,18114607,18114512,191
175,Chr4,1029364,1030745,1030054,1381
175,Chr4,1425329,1426951,1426140,1622
175,Chr4,10080747,10081275,10081011,528
175,Chr4,18311362,18312217,18311790,855
175,Chr5,3244755,3246543,3245649,1788
175,Chr5,16624426,16625023,16624724,597
175,Chr5,23953904,23954340,23954122,436
175,Chr5,25603565,25606197,25604881,2632
176,Chr1,4431865,4432380,4432123,515
176,Chr1,5643151,5643755,5643453,604
176,Chr1,9226241,9226752,9226497,511
176,Chr1,10214381,10214544,10214463,163
176,Chr1,18261295,18261356,18261325,61
176,Chr1,18855533,18855778,18855655,245
176,Chr1,20321008,20321327,20321168,319
176,Chr1,24012412,24012579,24012496,167
176,Chr1,28068366,28068745,28068556,379
176,Chr1,28724228,28739401,28731814,15173
176,Chr1,29731937,29732234,29732085,297
176,Chr2,385597,385684,385641,87
176,Chr2,8368093,8368334,8368213,241
176,Chr2,9749025,9749036,9749031,11
176,Chr2,17878346,17881639,17879992,3293
176,Chr2,18616502,18617013,18616758,511
176,Chr3,5749238,5752528,5750883,3290
176,Chr3,6644694,6646992,6645843,2298
176,Chr3,7113719,7116222,7114971,2503
176,Chr3,8663945,8664312,8664129,367
176,Chr3,10214125,10214514,10214319,389
176,Chr3,18281929,18282737,18282333,808
176,Chr4,7996113,7997810,7996961,1697
176,Chr4,8628363,8628705,8628534,342
176,Chr4,9354498,9354807,9354652,309
176,Chr5,2105367,2105437,2105402,70
176,Chr5,15880505,15880667,15880586,162
176,Chr5,22880182,22880682,22880432,500
176,Chr5,23829238,23830079,23829658,841
176,Chr5,25025984,25030334,25028159,4350
177,Chr1,1162324,1162447,1162386,123
177,Chr1,4231000,4232884,4231942,1884
177,Chr1,4985421,4986038,4985729,617
177,Chr1,13077108,13077389,13077248,281
177,Chr1,19874388,19874728,19874558,340
177,Chr1,20834467,20834960,20834713,493
177,Chr1,24052428,24053248,24052838,820
177,Chr1,28215906,28216031,28215968,125
177,Chr2,11014617,11015459,11015038,842
177,Chr2,11991100,11991344,11991222,244
177,Chr2,14336533,14336611,14336572,78
177,Chr2,17721713,17722465,17722089,752
177,Chr2,18145029,18154466,18149747,9437
177,Chr3,837944,838059,838002,115
177,Chr3,2945439,2945572,2945505,133
177,Chr3,3806042,3806699,3806370,657
177,Chr3,4987677,4988187,4987932,510
177,Chr3,6536028,6567142,6551585,31114
177,Chr3,19597827,19599021,19598424,1194
177,Chr4,12105706,12106610,12106158,904
177,Chr4,12956366,12957984,12957175,1618
177,Chr4,13648145,13648714,13648429,569
177,Chr4,14502449,14503021,14502735,572
177,Chr4,15195498,15197253,15196376,1755
177,Chr4,17044644,17044768,17044706,124
177,Chr5,2533590,2534644,2534117,1054
177,Chr5,6992414,6992759,6992586,345
177,Chr5,18908472,18908493,18908482,21
177,Chr5,20636899,20637465,20637182,566
177,Chr5,20946338,20946573,20946456,235
177,Chr5,23670613,23671345,23670979,732
177,Chr5,26022718,26022826,26022772,108
178,Chr1,4740751,4741697,4741224,946
178,Chr1,6015934,6017009,6016472,1075
178,Chr1,8549737,8549867,8549802,130
178,Chr1,17720622,17722548,17721585,1926
178,Chr1,23779868,23780339,23780104,471
178,Chr1,25500963,25511836,25506399,10873
178,Chr2,13105528,13106711,13106120,1183
178,Chr2,14954711,14955830,14955271,1119
178,Chr2,19629335,19629722,19629529,387
178,Chr3,4123260,4124302,4123781,1042
178,Chr3,5780430,5782770,5781600,2340
178,Chr3,16563952,16564173,16564062,221
178,Chr3,20801046,20801537,20801292,491
178,Chr3,22978019,22978226,22978123,207
178,Chr4,128710,129091,128900,381
178,Chr4,9343402,9343624,9343513,222
178,Chr4,11312229,11314125,11313177,1896
178,Chr4,13816294,13823571,13819932,7277
178,Chr4,14310756,14310887,14310822,131
178,Chr5,3385696,3387131,3386414,1435
178,Chr5,3738763,3739552,3739157,789
178,Chr5,5572045,5572442,5572243,397
178,Chr5,7679110,7679219,7679164,109
178,Chr5,18978240,18978476,18978358,236
178,Chr5,19806818,19812038,19809428,5220
178,Chr5,21675492,21676855,21676174,1363
178,Chr5,25579478,25580555,25580016,1077
179,Chr1,1238986,1239354,1239170,368
179,Chr1,4908188,4908724,4908456,536
179,Chr1,5367089,5367543,5367316,454
179,Chr1,9886467,9888445,9887456,1978
179,Chr1,18915314,18915710,18915512,396
179,Chr1,25157940,25158135,25158038,195
179,Chr1,26738586,26740398,26739492,1812
179,Chr1,28362064,28364685,28363374,2621
179,Chr1,28914399,28915035,28914717,636
179,Chr2,6289804,6290528,6290166,724
179,Chr2,7383154,7383298,7383226,144
179,Chr2,8324267,8324906,8324587,639
179,Chr2,15676288,15676333,15676310,45
179,Chr2,16891683,16892336,16892009,653
179,Chr2,18786257,18787480,18786869,1223
179,Chr2,19468251,19472211,19470231,3960
179,Chr3,1770232,1772826,1771529,2594
179,Chr3,3422249,3422831,3422540,582
179,Chr3,5165948,5182864,5174406,16916
179,Chr3,5294903,5307479,5301191,12576
179,Chr3,7664838,7664963,7664900,125
179,Chr3,9937969,9939262,9938615,1293
179,Chr3,10417338,10419436,10418387,2098
179,Chr3,16537932,16537996,16537964,64
179,Chr3,23362678,23363656,23363167,978
179,Chr4,718290,719620,718955,1330
179,Chr4,9160997,9161073,9161035,76
179,Chr4,10000741,10001282,10001011,541
179,Chr4,10586173,10586430,10586301,257
179,Chr4,13173936,13175865,13174900,1929
179,Chr5,1739071,1740798,1739935,1727
179,Chr5,4575696,4576228,4575962,532
179,Chr5,5816099,5817948,5817023,1849
179,Chr5,7884455,7885046,7884751,591
179,Chr5,14066543,14067592,14067067,1049
179,Chr5,18997831,18997963,18997897,132
179,Chr5,21978185,21978825,21978505,640
179,Chr5,23786927,23787657,23787292,730
179,Chr5,25068973,25069901,25069437,928
179,Chr5,26862391,26862899,26862645,508
18,Chr1,1655859,1656975,1656417,1116
18,Chr1,4032248,4032619,4032434,371
18,Chr1,8393239,8393447,8393343,208
18,Chr1,17330406,17330642,17330524,236
18,Chr1,27086145,27086563,27086354,418
18,Chr1,28504651,28511467,28508059,6816
18,Chr2,7757825,7759196,7758511,1371
18,Chr2,11580533,11580828,11580681,295
18,Chr2,19145564,19145882,19145723,318
18,Chr3,3511946,3512613,3512280,667
18,Chr3,5424189,5424359,5424274,170
18,Chr3,6914886,6929981,6922434,15095
18,Chr4,131680,132009,131844,329
18,Chr4,9391863,9391970,9391917,107
18,Chr4,13138903,13140931,13139917,2028
18,Chr4,18485336,18486752,18486044,1416
18,Chr5,462161,462909,462535,748
18,Chr5,2990803,2991648,2991225,845
18,Chr5,4043864,4045557,4044710,1693
18,Chr5,21840153,21840168,21840161,15
18,Chr5,25411309,25411656,25411483,347
18,Chr5,25720100,25721985,25721042,1885
18,Chr5,26205488,26206429,26205958,941
18,Chr5,26529371,26530569,26529970,1198
180,Chr1,1572348,1572461,1572404,113
180,Chr1,2932672,2936381,2934526,3709
180,Chr1,3635116,3637855,3636486,2739
180,Chr1,6364976,6365455,6365216,479
180,Chr1,16769573,16769625,16769599,52
180,Chr1,18030254,18030416,18030335,162
180,Chr1,18970944,19007704,18989324,36760
180,Chr1,19043546,19043833,19043690,287
180,Chr1,20312019,20312182,20312101,163
180,Chr1,22504411,22505754,22505083,1343
180,Chr1,28348522,28349633,28349078,1111
180,Chr1,29389709,29391390,29390549,1681
180,Chr2,2284201,2284253,2284227,52
180,Chr2,5676387,5676455,5676421,68
180,Chr2,11107661,11107875,11107768,214
180,Chr2,13493572,13495247,13494410,1675
180,Chr2,14651006,14655825,14653416,4819
180,Chr2,17586430,17588932,17587681,2502
180,Chr2,18588647,18589170,18588909,523
180,Chr2,19266173,19266734,19266453,561
180,Chr3,317646,318154,317900,508
180,Chr3,1251301,1251596,1251449,295
180,Chr3,18480165,18480774,18480469,609
180,Chr3,21092800,21093473,21093136,673
180,Chr3,21838230,21839137,21838684,907
180,Chr3,22322746,22323707,22323226,961
180,Chr3,22783313,22783477,22783395,164
180,Chr4,7686766,7687147,7686956,381
180,Chr4,9363219,9365553,9364386,2334
180,Chr4,11395063,11399326,11397195,4263
180,Chr4,12076745,12077169,12076957,424
180,Chr4,12691151,12692528,12691839,1377
180,Chr4,13204116,13205512,13204814,1396
180,Chr5,6673282,6673573,6673428,291
180,Chr5,16282224,16283465,16282844,1241
181,Chr1,1134230,1134414,1134322,184
181,Chr1,2346349,2347965,2347157,1616
181,Chr1,7049315,7049903,7049609,588
181,Chr1,7457166,7457226,7457196,60
181,Chr1,8310061,8311771,8310916,1710
181,Chr1,8597800,8598752,8598276,952
181,Chr1,9656372,9656765,9656568,393
181,Chr1,17702669,17703098,17702883,429
181,Chr1,18967416,18970804,18969110,3388
181,Chr1,24385359,24385471,24385415,112
181,Chr1,25303712,25304011,25303862,299
181,Chr1,25781424,25782909,25782166,1485
181,Chr1,28400718,28400746,28400732,28
181,Chr2,681345,681510,681427,165
181,Chr2,14907658,14908162,14907910,504
181,Chr2,16534084,16534606,16534345,522
181,Chr3,1595362,1597190,1596276,1828
181,Chr3,7288671,7288765,7288718,94
181,Chr3,9053546,9053702,9053624,156
181,Chr3,10388099,10388135,10388117,36
181,Chr3,23354409,23354634,23354521,225
181,Chr4,11918666,11919949,11919308,1283
181,Chr4,12871479,12877825,12874652,6346
181,Chr4,13617709,13619547,13618628,1838
181,Chr4,13723230,13764990,13744110,41760
181,Chr4,16572983,16573148,16573065,165
181,Chr4,17747193,17747292,17747243,99
181,Chr5,425993,426478,426235,485
181,Chr5,7563220,7563448,7563334,228
181,Chr5,22896550,22897255,22896902,705
182,Chr1,3354275,3361324,3357799,7049
182,Chr1,5973692,5974262,5973977,570
182,Chr1,8431089,8431217,8431153,128
182,Chr1,8878614,8879175,8878894,561
182,Chr1,10125567,10125784,10125675,217
182,Chr1,18441699,18442176,18441937,477
182,Chr1,21935211,21936364,21935787,1153
182,Chr1,26963189,26963832,26963511,643
182,Chr1,27514348,27514768,27514558,420
182,Chr1,29512121,29512434,29512277,313
182,Chr1,30275837,30276891,30276364,1054
182,Chr2,682346,683583,682964,1237
182,Chr2,1859697,1860010,1859853,313
182,Chr2,15913515,15914439,15913977,924
182,Chr3,1727008,1727244,1727126,236
182,Chr3,3666564,3666727,3666646,163
182,Chr3,21468762,21492444,21480603,23682
182,Chr3,21741793,21745308,21743551,3515
182,Chr3,23351530,23352140,23351835,610
182,Chr4,99694,99860,99777,166
182,Chr4,8512458,8513642,8513050,1184
182,Chr4,9122645,9123187,9122916,542
182,Chr4,11655212,11655263,11655238,51
182,Chr4,14308076,14308323,14308200,247
182,Chr5,3130900,3132450,3131675,1550
182,Chr5,4429106,4429216,4429161,110
182,Chr5,10646913,10647089,10647001,176
182,Chr5,22658098,22658620,22658359,522
182,Chr5,23227641,23229322,23228481,1681
182,Chr5,23474518,23474656,23474587,138
183,Chr1,3529232,3529412,3529322,180
183,Chr1,6852617,6852820,6852719,203
183,Chr1,6992696,6992894,6992795,198
183,Chr1,7452440,7452562,7452501,122
183,Chr1,8556751,8557397,8557074,646
183,Chr1,20796112,20796260,20796186,148
183,Chr2,387072,387431,387252,359
183,Chr2,2322634,2322902,2322768,268
183,Chr2,19610028,19610537,19610282,509
183,Chr3,73890,74162,74026,272
183,Chr3,1736694,1737204,1736949,510
183,Chr3,2774054,2774252,2774153,198
183,Chr3,3755223,3755368,3755295,145
183,Chr3,6282979,6283099,6283039,120
183,Chr3,8605938,8606433,8606186,495
183,Chr3,18799972,18801168,18800570,1196
183,Chr3,21189743,21189876,21189809,133
183,Chr3,22412359,22412704,22412531,345
183,Chr4,547515,549713,548614,2198
183,Chr4,1154102,1154619,1154360,517
183,Chr4,8139627,8140259,8139943,632
183,Chr4,8879577,8879668,8879623,91
183,Chr4,12858746,12860195,12859470,1449
183,Chr5,10262208,10262596,10262402,388
183,Chr5,16370888,16371147,16371018,259
183,Chr5,19677321,19678475,19677898,1154
183,Chr5,21037031,21037498,21037265,467
183,Chr5,24888932,24890953,24889942,2021
183,Chr5,25788006,25788377,25788192,371
184,Chr1,12504455,12509539,12506997,5084
184,Chr1,17765009,17765253,17765131,244
184,Chr2,7632027,7632646,7632337,619
184,Chr2,10908701,10908881,10908791,180
184,Chr2,11893997,11895392,11894695,1395
184,Chr3,5255037,5255479,5255258,442
184,Chr3,8109014,8109055,8109034,41
184,Chr3,16773545,16773845,16773695,300
184,Chr5,8912771,8914008,8913389,1237
184,Chr5,20075883,20075891,20075887,8
184,Chr5,22889386,22889742,22889564,356
184,Chr5,26816922,26817862,26817392,940
185,Chr1,1004842,1022802,1013822,17960
185,Chr1,26946662,26949224,26947943,2562
185,Chr1,29970074,29979973,29975024,9899
185,Chr2,5660815,5661176,5660995,361
185,Chr2,10835183,10835511,10835347,328
185,Chr2,14588212,14588414,14588313,202
185,Chr2,14782215,14784431,14783323,2216
185,Chr2,17357015,17357427,17357221,412
185,Chr2,19649509,19650566,19650037,1057
185,Chr3,1880297,1880623,1880460,326
185,Chr3,3232049,3232390,3232219,341
185,Chr3,5787485,5788436,5787961,951
185,Chr3,18787802,18788201,18788002,399
185,Chr4,8713384,8713486,8713435,102
185,Chr4,11307194,11309404,11308299,2210
185,Chr4,12099298,12100005,12099652,707
185,Chr4,14451787,14454690,14453239,2903
185,Chr5,1283309,1284216,1283763,907
185,Chr5,4286048,4286108,4286078,60
185,Chr5,18750244,18751829,18751036,1585
185,Chr5,23553602,23554508,23554055,906
186,Chr1,5343813,5344153,5343983,340
186,Chr1,23993982,23995218,23994600,1236
186,Chr1,26817457,26820348,26818903,2891
186,Chr1,30000318,30000514,30000416,196
186,Chr2,672483,672681,672582,198
186,Chr2,6329610,6345050,6337330,15440
186,Chr2,6921919,6921995,6921957,76
186,Chr2,7316590,7316682,7316636,92
186,Chr2,8581758,8582411,8582084,653
186,Chr2,13502237,13507130,13504683,4893
186,Chr2,14483753,14488310,14486031,4557
186,Chr2,15805594,15806472,15806033,878
186,Chr3,484505,487450,485977,2945
186,Chr3,2757155,2757299,2757227,144
186,Chr3,3446945,3447799,3447372,854
186,Chr3,19511263,19511351,19511307,88
186,Chr3,22111441,22112560,22112001,1119
186,Chr4,9178957,9179982,9179469,1025
186,Chr4,9835414,9835997,9835706,583
186,Chr4,11384861,11386019,11385440,1158
186,Chr4,13192723,13192786,13192755,63
186,Chr4,13720574,13722184,13721379,1610
186,Chr5,5513303,5514403,5513853,1100
186,Chr5,15725336,15725420,15725378,84
186,Chr5,16612249,16613252,16612751,1003
186,Chr5,21093451,21094565,21094008,1114
186,Chr5,24088314,24088547,24088430,233
187,Chr1,292110,292437,292274,327
187,Chr1,4225424,4228259,4226842,2835
187,Chr1,23043678,23044246,23043962,568
187,Chr1,24283943,24284075,24284009,132
187,Chr1,28178735,28179141,28178938,406
187,Chr2,397738,398681,398210,943
187,Chr2,6453016,6454454,6453735,1438
187,Chr2,11855191,11857425,11856308,2234
187,Chr2,13305663,13305862,13305763,199
187,Chr2,15778117,15779367,15778742,1250
187,Chr3,4759651,4763256,4761453,3605
187,Chr3,6334768,6335721,6335244,953
187,Chr3,19910636,19911122,19910879,486
187,Chr3,20052533,20052968,20052751,435
187,Chr3,21238629,21240410,21239519,1781
187,Chr3,21513104,21541501,21527302,28397
187,Chr3,22261633,22263388,22262511,1755
187,Chr4,5928334,5928392,5928363,58
187,Chr4,9118054,9118995,9118524,941
187,Chr4,13442574,13443523,13443048,949
187,Chr5,338665,338779,338722,114
187,Chr5,3851004,3858445,3854724,7441
187,Chr5,8945888,8946362,8946125,474
187,Chr5,9577664,9578326,9577995,662
188,Chr1,1423007,1423645,1423326,638
188,Chr1,3607374,3609284,3608329,1910
188,Chr1,5116659,5119148,5117903,2489
188,Chr1,20763242,20765792,20764517,2550
188,Chr1,25911230,25912006,25911618,776
188,Chr2,8219692,8222689,8221190,2997
188,Chr2,10763745,10764666,10764205,921
188,Chr2,12124196,12124372,12124284,176
188,Chr2,17524558,17525161,17524860,603
188,Chr3,305784,307158,306471,1374
188,Chr3,1794125,1795002,1794563,877
188,Chr3,3057031,3057122,3057077,91
188,Chr3,4737398,4738514,4737956,1116
188,Chr3,4887122,4887139,4887130,17
188,Chr3,5646444,5647060,5646752,616
188,Chr3,5837176,5837329,5837252,153
188,Chr3,6686250,6686904,6686577,654
188,Chr3,7573743,7574318,7574031,575
188,Chr3,9003616,9003841,9003728,225
188,Chr3,18140716,18140832,18140774,116
188,Chr3,18998744,18999418,18999081,674
188,Chr3,19073631,19073757,19073694,126
188,Chr3,22197517,22198199,22197858,682
188,Chr4,7223318,7223553,7223436,235
188,Chr4,18055324,18055606,18055465,282
188,Chr5,97174,97575,97374,401
188,Chr5,3844047,3845035,3844541,988
188,Chr5,5185423,5186337,5185880,914
188,Chr5,5387117,5387512,5387315,395
188,Chr5,16591976,16592281,16592128,305
188,Chr5,21424726,21425714,21425220,988
188,Chr5,24518888,24519588,24519238,700
189,Chr1,5070376,5072878,5071627,2502
189,Chr1,19487926,19488132,19488029,206
189,Chr2,15250413,15250696,15250555,283
189,Chr2,17365717,17369608,17367663,3891
189,Chr2,18311001,18311539,18311270,538
189,Chr2,19017521,19017749,19017635,228
189,Chr3,16004392,16005240,16004816,848
189,Chr3,18563863,18564215,18564039,352
189,Chr3,20373252,20373817,20373534,565
189,Chr3,22806461,22806673,22806567,212
189,Chr4,147422,148872,148147,1450
189,Chr4,7324637,7325353,7324995,716
189,Chr5,5741233,5741907,5741570,674
189,Chr5,6587431,6587510,6587471,79
189,Chr5,16537904,16538673,16538288,769
189,Chr5,21800878,21801502,21801190,624
189,Chr5,22498662,22499293,22498978,631
189,Chr5,26044131,26044395,26044263,264
19,Chr1,473429,478208,475819,4779
19,Chr1,5513816,5515406,5514611,1590
19,Chr1,6133548,6133785,6133666,237
19,Chr1,11767845,11769289,11768567,1444
19,Chr2,8763119,8763657,8763388,538
19,Chr2,11096359,11096868,11096613,509
19,Chr2,11853247,11855191,11854219,1944
19,Chr2,14827555,14840285,14833920,12730
19,Chr2,16620031,16620872,16620451,841
19,Chr2,17612750,17614185,17613468,1435
19,Chr3,6604125,6616262,6610193,12137
19,Chr3,8533768,8535351,8534560,1583
19,Chr3,10048483,10049054,10048769,571
19,Chr3,17797414,17798035,17797724,621
19,Chr3,22392013,22392098,22392055,85
19,Chr4,662353,663179,662766,826
19,Chr4,6383559,6383883,6383721,324
19,Chr5,7077259,7078095,7077677,836
19,Chr5,8157027,8158950,8157989,1923
19,Chr5,20107260,20149352,20128306,42092
19,Chr5,25185937,25186580,25186259,643
19,Chr5,26464117,26464475,26464296,358
190,Chr1,23531541,23531793,23531667,252
190,Chr1,27947005,27947868,27947437,863
190,Chr2,14168254,14174485,14171370,6231
190,Chr2,16671985,16676029,16674007,4044
190,Chr3,390248,392044,391146,1796
190,Chr3,4574565,4575190,4574877,625
190,Chr3,5079992,5124565,5102278,44573
190,Chr3,22097944,22098089,22098016,145
190,Chr3,23313158,23313464,23313311,306
190,Chr4,7491814,7492744,7492279,930
190,Chr4,10355957,10356348,10356153,391
190,Chr4,11217311,11219273,11218292,1962
190,Chr4,13878461,13879279,13878870,818
190,Chr5,828738,828850,828794,112
190,Chr5,1908464,1908628,1908546,164
190,Chr5,4177355,4179165,4178260,1810
190,Chr5,7634212,7636425,7635318,2213
190,Chr5,16838062,16838116,16838089,54
190,Chr5,22164133,22174106,22169119,9973
190,Chr5,26490686,26491269,26490978,583
191,Chr1,2104746,2105166,2104956,420
191,Chr1,9498023,9499256,9498639,1233
191,Chr1,17985764,17987562,17986663,1798
191,Chr1,19617482,19618426,19617954,944
191,Chr1,21101305,21101358,21101331,53
191,Chr1,21119484,21119725,21119604,241
191,Chr1,24141730,24144345,24143038,2615
191,Chr1,30249828,30250337,30250082,509
191,Chr2,7703696,7704659,7704178,963
191,Chr2,9492763,9495319,9494041,2556
191,Chr2,13298370,13298662,13298516,292
191,Chr2,14771775,14776116,14773945,4341
191,Chr2,18001293,18001644,18001469,351
191,Chr3,1826500,1826973,1826736,473
191,Chr3,2855665,2857673,2856669,2008
191,Chr3,3860113,3860375,3860244,262
191,Chr3,5749238,5752528,5750883,3290
191,Chr3,6536028,6567142,6551585,31114
191,Chr3,7616023,7617940,7616981,1917
191,Chr3,20199860,20200313,20200086,453
191,Chr3,21010268,21011977,21011122,1709
191,Chr3,21181376,21181575,21181476,199
191,Chr4,170859,171522,171191,663
191,Chr4,8154602,8154922,8154762,320
191,Chr4,12569774,12570641,12570208,867
191,Chr5,2804898,2815853,2810376,10955
191,Chr5,3851004,3858445,3854724,7441
191,Chr5,5954993,5955227,5955110,234
191,Chr5,15219619,15219696,15219657,77
191,Chr5,22073660,22074132,22073896,472
191,Chr5,26253396,26253544,26253470,148
191,Chr5,26708943,26709128,26709035,185
192,Chr1,858097,986719,922408,128622
192,Chr1,2627547,2628718,2628133,1171
192,Chr1,18431918,18432321,18432120,403
192,Chr1,19044663,19044695,19044679,32
192,Chr2,6950716,6951324,6951020,608
192,Chr2,9694162,9694295,9694228,133
192,Chr2,11340906,11341495,11341200,589
192,Chr2,13141824,13145298,13143561,3474
192,Chr2,15519273,15519522,15519397,249
192,Chr3,5483910,5485603,5484756,1693
192,Chr3,6439892,6440988,6440440,1096
192,Chr3,17892546,17892831,17892688,285
192,Chr3,21871846,21872106,21871976,260
192,Chr3,23288969,23289618,23289293,649
192,Chr4,5708809,5709658,5709233,849
192,Chr4,9753701,9753853,9753777,152
192,Chr4,12996952,12997651,12997302,699
192,Chr5,1907415,1907737,1907576,322
192,Chr5,5695045,5697623,5696334,2578
192,Chr5,21437117,21438433,21437775,1316
192,Chr5,23175151,23214138,23194645,38987
192,Chr5,23618382,23620125,23619254,1743
192,Chr5,25642299,25644695,25643497,2396
2,Chr1,2520618,2520724,2520671,106
2,Chr1,11180937,11183383,11182160,2446
2,Chr1,11921283,11925202,11923243,3919
2,Chr1,18821868,18823683,18822776,1815
2,Chr1,25656206,25657015,25656610,809
2,Chr1,27177990,27178170,27178080,180
2,Chr1,27302517,27302676,27302597,159
2,Chr2,681345,682346,681845,1001
2,Chr2,5658689,5660238,5659463,1549
2,Chr2,8430772,8430920,8430846,148
2,Chr2,9250261,9256626,9253443,6365
2,Chr2,9389374,9389671,9389522,297
2,Chr2,16757784,16758307,16758046,523
2,Chr2,19467282,19467401,19467342,119
2,Chr3,2848524,2849342,2848933,818
2,Chr3,17562633,17563101,17562867,468
2,Chr4,5639006,5639501,5639254,495
2,Chr4,7256405,7256848,7256627,443
2,Chr4,9804448,9804815,9804632,367
2,Chr5,525738,530555,528146,4817
2,Chr5,6945929,6948052,6946991,2123
2,Chr5,16127126,16129010,16128068,1884
2,Chr5,16657329,16657523,16657426,194
2,Chr5,20743993,20747559,20745776,3566
2,Chr5,24095745,24096110,24095927,365
20,Chr1,3091618,3092286,3091952,668
20,Chr1,7118491,7120370,7119431,1879
20,Chr1,8486684,8486824,8486754,140
20,Chr1,17334622,17335316,17334969,694
20,Chr1,24109913,24110069,24109991,156
20,Chr1,26147682,26171795,26159738,24113
20,Chr1,27387959,27388036,27387997,77
20,Chr1,28456198,28477388,28466793,21190
20,Chr1,29376595,29381754,29379175,5159
20,Chr1,30268389,30269146,30268767,757
20,Chr2,448569,448630,448599,61
20,Chr2,608355,608848,608601,493
20,Chr2,6371368,6371466,6371417,98
20,Chr2,13386787,13387557,13387172,770
20,Chr2,15224222,15225630,15224926,1408
20,Chr2,15645515,15647619,15646567,2104
20,Chr2,18915665,18915725,18915695,60
20,Chr2,19491504,19491889,19491696,385
20,Chr3,7040536,7044650,7042593,4114
20,Chr3,18752897,18753349,18753123,452
20,Chr3,21673478,21677904,21675691,4426
20,Chr3,23353679,23353786,23353733,107
20,Chr4,18314915,18315277,18315096,362
20,Chr5,1519142,1519644,1519393,502
20,Chr5,2946322,2947990,2947156,1668
20,Chr5,4066009,4067105,4066557,1096
20,Chr5,5071235,5073133,5072184,1898
20,Chr5,9015384,9016643,9016014,1259
20,Chr5,15952963,15953071,15953017,108
20,Chr5,16538673,16539398,16539035,725
20,Chr5,20098452,20098521,20098486,69
20,Chr5,25753586,25753717,25753652,131
21,Chr1,844413,850465,847439,6052
21,Chr1,5799535,5803149,5801342,3614
21,Chr1,7147761,7152505,7150133,4744
21,Chr1,8574912,8576111,8575512,1199
21,Chr1,8977128,8985127,8981128,7999
21,Chr1,10274000,10275459,10274730,1459
21,Chr1,25319769,25322931,25321350,3162
21,Chr1,26508909,26509698,26509303,789
21,Chr1,27297419,27297616,27297517,197
21,Chr1,28568888,28569126,28569007,238
21,Chr1,28876128,28877065,28876596,937
21,Chr2,11361901,11362015,11361958,114
21,Chr2,16442854,16442972,16442913,118
21,Chr3,127683,131024,129353,3341
21,Chr3,2846533,2848524,2847529,1991
21,Chr3,3817723,3821818,3819771,4095
21,Chr3,4234998,4235384,4235191,386
21,Chr3,17015505,17015844,17015675,339
21,Chr3,18647323,18651338,18649331,4015
21,Chr3,19625069,19625275,19625172,206
21,Chr4,476264,478305,477284,2041
21,Chr4,6704452,6704736,6704594,284
21,Chr4,7666264,7667570,7666917,1306
21,Chr4,13461545,13461624,13461585,79
21,Chr5,332945,333018,332981,73
21,Chr5,20232331,20232744,20232537,413
21,Chr5,24086220,24086610,24086415,390
22,Chr1,1576472,1578928,1577700,2456
22,Chr1,4924652,4925172,4924912,520
22,Chr1,5435477,5436167,5435822,690
22,Chr1,6966146,6966232,6966189,86
22,Chr1,8976678,8977128,8976903,450
22,Chr2,9575005,9577159,9576082,2154
22,Chr2,10431626,10431644,10431635,18
22,Chr2,10977087,10977404,10977245,317
22,Chr2,13182696,13186427,13184562,3731
22,Chr2,19016151,19017301,19016726,1150
22,Chr2,19516773,19516812,19516793,39
22,Chr3,1457444,1458718,1458081,1274
22,Chr3,9465004,9465254,9465129,250
22,Chr5,25389,26691,26040,1302
22,Chr5,157021,157096,157059,75
22,Chr5,2886999,2888044,2887521,1045
22,Chr5,5399001,5399999,5399500,998
22,Chr5,5838221,5838637,5838429,416
22,Chr5,10933086,10933516,10933301,430
22,Chr5,16424061,16424607,16424334,546
22,Chr5,18104641,18105493,18105067,852
22,Chr5,22898014,22898239,22898126,225
23,Chr1,784491,797322,790907,12831
23,Chr1,3321865,3323366,3322615,1501
23,Chr1,6238889,6239439,6239164,550
23,Chr1,10263200,10263936,10263568,736
23,Chr1,23267159,23267481,23267320,322
23,Chr2,9991665,9991911,9991788,246
23,Chr2,11247433,11247440,11247437,7
23,Chr2,12956333,12956404,12956369,71
23,Chr2,17115379,17115421,17115400,42
23,Chr2,18005825,18009058,18007441,3233
23,Chr2,18591645,18591711,18591678,66
23,Chr3,378112,378162,378137,50
23,Chr3,9738633,9738732,9738683,99
23,Chr3,16563825,16563952,16563889,127
23,Chr3,19025115,19025465,19025290,350
23,Chr3,21242698,21243607,21243152,909
23,Chr3,23292405,23292867,23292636,462
23,Chr4,8049713,8050030,8049871,317
23,Chr4,9179969,9179982,9179975,13
23,Chr5,271872,277216,274544,5344
23,Chr5,1901414,1901626,1901520,212
23,Chr5,16851590,16852261,16851926,671
23,Chr5,17315911,17315976,17315943,65
23,Chr5,26923897,26924671,26924284,774
24,Chr1,4771792,4772893,4772342,1101
24,Chr1,18771091,18772500,18771795,1409
24,Chr1,30365406,30366404,30365905,998
24,Chr2,9549356,9550330,9549843,974
24,Chr2,14388604,14390743,14389674,2139
24,Chr2,14925181,14929666,14927423,4485
24,Chr3,5418914,5419872,5419393,958
24,Chr3,19627662,19627770,19627716,108
24,Chr3,21828823,21828908,21828865,85
24,Chr3,22364020,22364242,22364131,222
24,Chr4,8922529,8922801,8922665,272
24,Chr4,10152628,10152740,10152684,112
24,Chr4,12688041,12690968,12689505,2927
24,Chr5,3215289,3215635,3215462,346
24,Chr5,4573854,4574027,4573940,173
24,Chr5,7958580,7960072,7959326,1492
24,Chr5,25093170,25093739,25093454,569
24,Chr5,25792116,25792458,25792287,342
25,Chr1,739731,740670,740201,939
25,Chr1,3609284,3615989,3612636,6705
25,Chr1,9181319,9183469,9182394,2150
25,Chr1,9196886,9198263,9197574,1377
25,Chr1,18752626,18753107,18752866,481
25,Chr1,19863066,19865655,19864360,2589
25,Chr1,27959750,27959839,27959794,89
25,Chr1,30144562,30145081,30144822,519
25,Chr2,493516,493537,493526,21
25,Chr2,2074153,2181177,2127665,107024
25,Chr2,7265475,7266796,7266135,1321
25,Chr2,12177937,12178348,12178143,411
25,Chr2,12985023,12985033,12985028,10
25,Chr2,15066702,15069413,15068058,2711
25,Chr2,16803485,16807182,16805333,3697
25,Chr2,17452960,17455983,17454472,3023
25,Chr2,18018004,18018328,18018166,324
25,Chr3,5633774,5633896,5633835,122
25,Chr3,6038791,6039405,6039098,614
25,Chr3,6616058,6616262,6616160,204
25,Chr3,9308049,9308296,9308173,247
25,Chr3,22816509,22816908,22816709,399
25,Chr4,5494879,5495463,5495171,584
25,Chr4,8219462,8219590,8219526,128
25,Chr4,8852836,8852847,8852842,11
25,Chr4,10161110,10162487,10161798,1377
25,Chr4,14077224,14079016,14078120,1792
25,Chr4,18485336,18486752,18486044,1416
25,Chr5,570137,570356,570247,219
25,Chr5,3620047,3627249,3623648,7202
25,Chr5,4664060,4665320,4664690,1260
25,Chr5,4847061,4847421,4847241,360
25,Chr5,6604489,6605717,6605103,1228
25,Chr5,14644889,14645015,14644952,126
25,Chr5,19222397,19225155,19223776,2758
25,Chr5,20030788,20030855,20030822,67
25,Chr5,20660230,20661466,20660848,1236
25,Chr5,23941043,23941548,23941295,505
25,Chr5,25115903,25118405,25117154,2502
26,Chr1,314437,371972,343205,57535
26,Chr1,1785557,1788691,1787124,3134
26,Chr1,9453140,9453431,9453286,291
26,Chr1,12313637,12316537,12315087,2900
26,Chr1,19043546,19043833,19043690,287
26,Chr1,20259997,20276105,20268051,16108
26,Chr1,23777816,23778306,23778061,490
26,Chr1,29965901,29970074,29967987,4173
26,Chr2,589173,591186,590179,2013
26,Chr2,7751208,7753412,7752310,2204
26,Chr2,10822583,10824216,10823399,1633
26,Chr2,12361056,12362096,12361576,1040
26,Chr2,14185668,14186025,14185846,357
26,Chr2,14943895,14944044,14943969,149
26,Chr3,1608200,1609414,1608807,1214
26,Chr3,2931906,2933542,2932724,1636
26,Chr3,4603486,4604374,4603930,888
26,Chr3,6145746,6146454,6146100,708
26,Chr3,18290774,18291237,18291006,463
26,Chr3,19275606,19275914,19275760,308
26,Chr3,20196837,20197080,20196959,243
26,Chr3,20602120,20603229,20602674,1109
26,Chr4,5634197,5635296,5634747,1099
26,Chr4,17982860,17984927,17983894,2067
26,Chr4,18353035,18355232,18354133,2197
26,Chr5,4349429,4350381,4349905,952
26,Chr5,8848670,8849169,8848920,499
26,Chr5,9258340,9258744,9258542,404
26,Chr5,24406359,24406996,24406677,637
26,Chr5,26908487,26909353,26908920,866
27,Chr1,700614,700793,700704,179
27,Chr1,3619818,3621441,3620630,1623
27,Chr1,10298284,10298521,10298402,237
27,Chr1,11438507,11439073,11438790,566
27,Chr1,20820748,20821513,20821130,765
27,Chr1,24442600,24443738,24443169,1138
27,Chr2,6775258,6775534,6775396,276
27,Chr2,9348736,9348755,9348746,19
27,Chr2,9827203,9828199,9827701,996
27,Chr2,11526673,11526858,11526765,185
27,Chr2,13480867,13483188,13482027,2321
27,Chr2,16904043,16905370,16904707,1327
27,Chr2,17878075,17878346,17878211,271
27,Chr2,19587424,19588080,19587752,656
27,Chr3,1281146,1282003,1281574,857
27,Chr3,2295159,2295395,2295277,236
27,Chr3,6686904,6688365,6687634,1461
27,Chr3,18708431,18709139,18708785,708
27,Chr4,6817438,6817702,6817570,264
27,Chr5,84356,89507,86932,5151
27,Chr5,2279171,2282868,2281019,3697
27,Chr5,9713163,9716705,9714934,3542
27,Chr5,13611739,13611879,13611809,140
27,Chr5,19105268,19106203,19105736,935
27,Chr5,20220890,20222078,20221484,1188
27,Chr5,23041550,23041948,23041749,398
28,Chr1,5638876,5639760,5639318,884
28,Chr1,9448219,9448345,9448282,126
28,Chr1,26065076,26065816,26065446,740
28,Chr1,29497643,29497763,29497703,120
28,Chr1,29938918,29940890,29939904,1972
28,Chr2,11329540,11329760,11329650,220
28,Chr2,14790123,14793183,14791653,3060
28,Chr2,16887357,16887916,16887637,559
28,Chr3,2633170,2633706,2633438,536
28,Chr3,8038132,8038617,8038374,485
28,Chr3,10783363,10790271,10786817,6908
28,Chr3,10909027,10909289,10909158,262
28,Chr3,18220442,18220512,18220477,70
28,Chr3,21747155,21747303,21747229,148
28,Chr3,23327443,23328297,23327870,854
28,Chr4,6927440,6929713,6928576,2273
28,Chr5,24940843,24941353,24941098,510
29,Chr1,11808845,11809280,11809063,435
29,Chr1,19050086,19050260,19050173,174
29,Chr1,20045491,20046228,20045859,737
29,Chr1,28260141,28260571,28260356,430
29,Chr1,29335051,29337106,29336079,2055
29,Chr2,16455743,16456164,16455953,421
29,Chr3,1480193,1481467,1480830,1274
29,Chr3,2420696,2420990,2420843,294
29,Chr3,5079992,5124565,5102278,44573
29,Chr3,8176659,8176885,8176772,226
29,Chr3,10355181,10355324,10355253,143
29,Chr3,19206626,19206763,19206694,137
29,Chr3,20868664,20868796,20868730,132
29,Chr3,22623926,22624008,22623967,82
29,Chr4,308466,310786,309626,2320
29,Chr4,9044878,9046742,9045810,1864
29,Chr4,10055146,10057426,10056286,2280
29,Chr4,11968427,11969171,11968799,744
29,Chr4,13080147,13081233,13080690,1086
29,Chr4,13410109,13415366,13412737,5257
29,Chr4,14502385,14502449,14502417,64
29,Chr5,202216,203599,202908,1383
29,Chr5,2822183,2831387,2826785,9204
29,Chr5,4898981,4900514,4899747,1533
29,Chr5,5260896,5261747,5261322,851
29,Chr5,10190869,10192256,10191563,1387
29,Chr5,16673182,16673576,16673379,394
29,Chr5,18019776,18019836,18019806,60
29,Chr5,20910227,20910365,20910296,138
3,Chr1,1065532,1067618,1066575,2086
3,Chr1,21058758,21059587,21059172,829
3,Chr1,24743940,24744401,24744170,461
3,Chr1,27421315,27426586,27423951,5271
3,Chr2,14631148,14632304,14631726,1156
3,Chr2,14647031,14647173,14647102,142
3,Chr2,15138615,15138731,15138673,116
3,Chr2,16200950,16201793,16201372,843
3,Chr2,17208640,17208792,17208716,152
3,Chr3,3241867,3254469,3248168,12602
3,Chr3,6798218,6799097,6798658,879
3,Chr3,17592033,17593325,17592679,1292
3,Chr4,18294032,18294898,18294465,866
3,Chr5,4200042,4201810,4200926,1768
3,Chr5,6480529,6480730,6480629,201
3,Chr5,8567471,8569241,8568356,1770
3,Chr5,20941287,20941544,20941415,257
3,Chr5,26748648,26748816,26748732,168
30,Chr1,2969252,2970412,2969832,1160
30,Chr1,20565838,20566219,20566028,381
30,Chr1,23638795,23640430,23639613,1635
30,Chr1,23640430,23640568,23640499,138
30,Chr1,26183333,26183551,26183442,218
30,Chr1,28388448,28389056,28388752,608
30,Chr1,29309432,29309486,29309459,54
30,Chr1,29735854,29736419,29736136,565
30,Chr2,16134796,16136362,16135579,1566
30,Chr3,847617,847759,847688,142
30,Chr3,1806221,1806634,1806427,413
30,Chr3,5256873,5257673,5257273,800
30,Chr3,5994053,5995945,5994999,1892
30,Chr3,8554208,8555008,8554608,800
30,Chr3,9977511,9977631,9977571,120
30,Chr3,22126906,22128563,22127734,1657
30,Chr4,5301153,5301387,5301270,234
30,Chr4,8445831,8446278,8446055,447
30,Chr4,13410109,13415366,13412737,5257
30,Chr5,2026820,2028216,2027518,1396
30,Chr5,4457187,4457409,4457298,222
30,Chr5,15376593,15378355,15377474,1762
30,Chr5,18112862,18132785,18122824,19923
30,Chr5,24326601,24327971,24327286,1370
31,Chr1,2741927,2742370,2742149,443
31,Chr1,7484303,7484822,7484563,519
31,Chr1,25469720,25470288,25470004,568
31,Chr2,181007,181285,181146,278
31,Chr2,9534997,9536002,9535499,1005
31,Chr2,11227707,11228101,11227904,394
31,Chr2,19020006,19020654,19020330,648
31,Chr3,110693,112807,111750,2114
31,Chr3,7394284,7397662,7395973,3378
31,Chr3,19746136,19747051,19746594,915
31,Chr4,6314961,6315245,6315103,284
31,Chr4,7420517,7420841,7420679,324
31,Chr4,9278616,9278726,9278671,110
31,Chr4,10946255,10946262,10946259,7
31,Chr4,17850934,17853554,17852244,2620
31,Chr4,18259910,18260063,18259986,153
31,Chr5,2585269,2585893,2585581,624
31,Chr5,5063144,5071235,5067190,8091
31,Chr5,5640640,5641772,5641206,1132
31,Chr5,19282694,19283409,19283052,715
31,Chr5,25518116,25518524,25518320,408
32,Chr1,1703345,1703448,1703397,103
32,Chr1,7535609,7535819,7535714,210
32,Chr1,8481901,8484730,8483315,2829
32,Chr1,11573660,11573794,11573727,134
32,Chr1,19510469,19511199,19510834,730
32,Chr1,27622567,27624095,27623331,1528
32,Chr1,29219225,29219791,29219508,566
32,Chr2,6022849,6022964,6022907,115
32,Chr2,9556547,9556618,9556583,71
32,Chr2,12017260,12022648,12019954,5388
32,Chr3,4766835,4768252,4767543,1417
32,Chr3,7843011,7845128,7844069,2117
32,Chr3,10076024,10077467,10076746,1443
32,Chr3,20889456,20890496,20889976,1040
32,Chr4,6513922,6514070,6513996,148
32,Chr4,7718601,7718892,7718747,291
32,Chr4,8607245,8608007,8607626,762
32,Chr4,12955670,12956032,12955851,362
32,Chr4,13510411,13512245,13511328,1834
32,Chr5,282955,283104,283029,149
32,Chr5,1704659,1704886,1704773,227
32,Chr5,8378923,8379249,8379086,326
32,Chr5,9725912,9726902,9726407,990
32,Chr5,18751829,18752020,18751925,191
32,Chr5,20763389,20764196,20763793,807
32,Chr5,23700738,23701171,23700954,433
32,Chr5,24205012,24207823,24206418,2811
32,Chr5,25336064,25336085,25336074,21
32,Chr5,26567943,26568061,26568002,118
32,Chr5,26886524,26887873,26887198,1349
33,Chr1,210319,266254,238287,55935
33,Chr1,1480907,1481694,1481301,787
33,Chr1,4969845,4977190,4973517,7345
33,Chr1,6389057,6390631,6389844,1574
33,Chr1,8596567,8596854,8596711,287
33,Chr1,9077075,9077832,9077453,757
33,Chr1,9227501,9228035,9227768,534
33,Chr1,11116612,11117527,11117070,915
33,Chr1,30207906,30209205,30208556,1299
33,Chr2,675334,677909,676622,2575
33,Chr2,18594756,18594856,18594806,100
33,Chr2,18802006,18803520,18802763,1514
33,Chr3,8112661,8114951,8113806,2290
33,Chr3,10961579,10962231,10961905,652
33,Chr5,2560754,2561293,2561024,539
33,Chr5,3012523,3012978,3012751,455
33,Chr5,3522017,3522690,3522353,673
33,Chr5,6477775,6478110,6477943,335
33,Chr5,17806228,17806349,17806288,121
33,Chr5,23812008,23812202,23812105,194
33,Chr5,24393705,24394213,24393959,508
33,Chr5,25461636,25462183,25461910,547
34,Chr1,1585099,1585430,1585265,331
34,Chr1,3615488,3615989,3615738,501
34,Chr1,4630724,4631551,4631138,827
34,Chr1,4899961,4900870,4900415,909
34,Chr1,5626281,5626425,5626353,144
34,Chr1,7755743,7755911,7755827,168
34,Chr1,9339710,9341235,9340472,1525
34,Chr1,12741687,12741747,12741717,60
34,Chr1,26320205,26320431,26320318,226
34,Chr1,28112686,28113093,28112890,407
34,Chr1,30310328,30310757,30310542,429
34,Chr2,12263853,12264075,12263964,222
34,Chr2,14483396,14483753,14483574,357
34,Chr2,15452834,15453016,15452925,182
34,Chr2,18514340,18515119,18514730,779
34,Chr2,18941237,18944311,18942774,3074
34,Chr2,19045218,19046878,19046048,1660
34,Chr3,3201248,3201478,3201363,230
34,Chr3,7505132,7505755,7505444,623
34,Chr3,8105390,8105601,8105496,211
34,Chr3,9270299,9270551,9270425,252
34,Chr3,10031635,10032004,10031819,369
34,Chr3,11242257,11243053,11242655,796
34,Chr3,19010184,19010545,19010364,361
34,Chr3,22129385,22129894,22129639,509
34,Chr4,10718795,10719173,10718984,378
34,Chr4,11566371,11566613,11566492,242
34,Chr4,12794952,12795289,12795120,337
34,Chr4,13294365,13294465,13294415,100
34,Chr4,18389105,18389641,18389373,536
34,Chr5,1600786,1601185,1600986,399
34,Chr5,4948323,4950444,4949383,2121
34,Chr5,6725538,6726957,6726248,1419
34,Chr5,7969414,7969707,7969560,293
34,Chr5,15133960,15134104,15134032,144
34,Chr5,16489860,16490359,16490110,499
34,Chr5,18012738,18015454,18014096,2716
34,Chr5,23233151,23235819,23234485,2668
34,Chr5,24332276,24333330,24332803,1054
34,Chr5,25778167,25779319,25778743,1152
34,Chr5,26372698,26374411,26373554,1713
35,Chr1,3928005,3929277,3928641,1272
35,Chr1,7081281,7083753,7082517,2472
35,Chr1,8631980,8632994,8632487,1014
35,Chr1,19535240,19536130,19535685,890
35,Chr1,20787979,20789893,20788936,1914
35,Chr1,25539380,25549775,25544578,10395
35,Chr1,26043950,26044629,26044290,679
35,Chr2,8171913,8175118,8173515,3205
35,Chr2,9656825,9657306,9657065,481
35,Chr2,11646139,11646544,11646341,405
35,Chr2,12493783,12494099,12493941,316
35,Chr3,202062,202249,202156,187
35,Chr3,4369685,4370569,4370127,884
35,Chr3,18941430,18941883,18941656,453
35,Chr3,21677904,21681549,21679726,3645
35,Chr4,11550901,11552896,11551899,1995
35,Chr4,17819701,17820088,17819895,387
35,Chr5,25389,26691,26040,1302
35,Chr5,1001486,1002253,1001870,767
35,Chr5,1023760,1024068,1023914,308
35,Chr5,2400254,2401254,2400754,1000
35,Chr5,5231541,5232404,5231973,863
35,Chr5,17144225,17144954,17144589,729
35,Chr5,19175937,19176215,19176076,278
35,Chr5,20748374,20752809,20750592,4435
35,Chr5,26907240,26907482,26907361,242
37,Chr1,183623,207856,195739,24233
37,Chr1,19203898,19204102,19204000,204
37,Chr1,21562876,21563843,21563360,967
37,Chr1,23466026,23467077,23466552,1051
37,Chr1,26495630,26500854,26498242,5224
37,Chr1,28965278,28965523,28965400,245
37,Chr2,368988,369164,369076,176
37,Chr2,11617635,11617830,11617733,195
37,Chr2,17488750,17488925,17488838,175
37,Chr2,19298637,19299765,19299201,1128
37,Chr3,116833,120693,118763,3860
37,Chr3,2253523,2254013,2253768,490
37,Chr3,5371646,5372409,5372028,763
37,Chr3,6753107,6753862,6753485,755
37,Chr3,7351998,7352296,7352147,298
37,Chr3,18461197,18464572,18462885,3375
37,Chr3,20531129,20531962,20531545,833
37,Chr3,21231375,21231393,21231384,18
37,Chr4,8057396,8057519,8057458,123
37,Chr4,18139304,18142015,18140660,2711
37,Chr4,18177274,18177366,18177320,92
37,Chr5,4955406,4956408,4955907,1002
37,Chr5,6883865,6885756,6884811,1891
37,Chr5,7527148,7527213,7527180,65
37,Chr5,9743794,9744710,9744252,916
37,Chr5,21142127,21143374,21142751,1247
37,Chr5,24415635,24416032,24415833,397
37,Chr5,25016529,25017068,25016799,539
38,Chr1,2277469,2279907,2278688,2438
38,Chr1,3184713,3184848,3184781,135
38,Chr1,6898729,6899862,6899295,1133
38,Chr1,9895488,9895755,9895622,267
38,Chr1,22028483,22028638,22028561,155
38,Chr1,23519179,23520273,23519726,1094
38,Chr1,24536769,24536953,24536861,184
38,Chr1,27302776,27303998,27303387,1222
38,Chr2,756368,756441,756404,73
38,Chr2,8192541,8197211,8194876,4670
38,Chr2,9213366,9213651,9213508,285
38,Chr2,11580239,11580533,11580386,294
38,Chr2,16795614,16796358,16795986,744
38,Chr2,18145029,18154466,18149747,9437
38,Chr3,3698919,3699777,3699348,858
38,Chr3,5746408,5748134,5747271,1726
38,Chr3,10145111,10145208,10145159,97
38,Chr3,18977452,18977947,18977700,495
38,Chr3,21143526,21143698,21143612,172
38,Chr3,21916482,21917453,21916968,971
38,Chr4,733140,733599,733370,459
38,Chr4,9943973,9948681,9946327,4708
38,Chr4,18041956,18043359,18042658,1403
38,Chr5,4131511,4133080,4132295,1569
38,Chr5,5063144,5071235,5067190,8091
38,Chr5,5433915,5434734,5434325,819
38,Chr5,24166741,24166793,24166767,52
38,Chr5,25054447,25054831,25054639,384
38,Chr5,26621174,26621481,26621328,307
39,Chr1,1022802,1064221,1043512,41419
39,Chr1,2298564,2301293,2299928,2729
39,Chr1,5148815,5149536,5149175,721
39,Chr1,9463710,9472228,9467969,8518
39,Chr2,1696583,1696617,1696600,34
39,Chr2,9666249,9667013,9666631,764
39,Chr2,12124196,12124372,12124284,176
39,Chr2,13664345,13664952,13664649,607
39,Chr2,16333398,16333555,16333476,157
39,Chr3,1013060,1013116,1013088,56
39,Chr3,5917162,5917322,5917242,160
39,Chr3,9958128,9959240,9958684,1112
39,Chr3,10412831,10413401,10413116,570
39,Chr3,19824828,19825138,19824983,310
39,Chr3,22368240,22368249,22368244,9
39,Chr3,22978019,22978226,22978123,207
39,Chr4,7223776,7224005,7223890,229
39,Chr4,9278726,9279924,9279325,1198
39,Chr4,14007283,14008187,14007735,904
39,Chr5,3811963,3813104,3812533,1141
39,Chr5,20098278,20098373,20098326,95
39,Chr5,24862641,24862899,24862770,258
4,Chr1,1221161,1221314,1221237,153
4,Chr1,5380746,5381832,5381289,1086
4,Chr1,17894339,17895180,17894759,841
4,Chr1,19090709,19092357,19091533,1648
4,Chr1,22497397,22499588,22498493,2191
4,Chr1,30331063,30331756,30331409,693
4,Chr2,527481,527817,527649,336
4,Chr2,7635456,7636240,7635848,784
4,Chr2,14023715,14023823,14023769,108
4,Chr3,996634,999447,998040,2813
4,Chr3,1368984,1369252,1369118,268
4,Chr3,3087457,3089793,3088625,2336
4,Chr3,5124565,5135037,5129801,10472
4,Chr3,5863076,5863152,5863114,76
4,Chr3,6688365,6696991,6692678,8626
4,Chr3,11285185,11285215,11285200,30
4,Chr3,18466491,18467460,18466975,969
4,Chr3,19587609,19588034,19587821,425
4,Chr3,21352460,21352798,21352629,338
4,Chr4,495738,496571,496154,833
4,Chr4,9727915,9728303,9728109,388
4,Chr4,10847304,10847358,10847331,54
4,Chr5,1901050,1901402,1901226,352
4,Chr5,4444627,4445057,4444842,430
4,Chr5,8970503,8981546,8976025,11043
4,Chr5,14277381,14277788,14277585,407
4,Chr5,21554514,21555901,21555208,1387
4,Chr5,23355960,23357563,23356762,1603
4,Chr5,24885576,24885711,24885644,135
40,Chr1,3440720,3441906,3441313,1186
40,Chr1,18914101,18915314,18914707,1213
40,Chr1,20525598,20526066,20525832,468
40,Chr1,26103141,26103351,26103246,210
40,Chr2,1941207,1941406,1941307,199
40,Chr2,9034495,9035989,9035242,1494
40,Chr2,12944724,12944830,12944777,106
40,Chr2,14563078,14563602,14563340,524
40,Chr2,17371235,17372984,17372109,1749
40,Chr2,19092333,19094192,19093263,1859
40,Chr3,6467306,6468618,6467962,1312
40,Chr3,10421123,10421551,10421337,428
40,Chr3,19155854,19158051,19156952,2197
40,Chr4,8188311,8188356,8188333,45
40,Chr4,11722192,11722896,11722544,704
40,Chr4,13349785,13350896,13350341,1111
40,Chr5,1635960,1636544,1636252,584
40,Chr5,1991404,1991882,1991643,478
40,Chr5,2822109,2831387,2826748,9278
40,Chr5,4413173,4413445,4413309,272
40,Chr5,8784472,8786457,8785464,1985
40,Chr5,24675313,24677370,24676341,2057
40,Chr5,25731504,25732097,25731800,593
41,Chr1,1004842,1022802,1013822,17960
41,Chr1,6179698,6182582,6181140,2884
41,Chr1,8388200,8391346,8389773,3146
41,Chr1,11677799,11678763,11678281,964
41,Chr1,20345148,20350818,20347983,5670
41,Chr1,20426747,20426920,20426833,173
41,Chr1,28454138,28454226,28454182,88
41,Chr1,29749252,29749356,29749304,104
41,Chr1,30152108,30152255,30152182,147
41,Chr2,8550136,8551940,8551038,1804
41,Chr2,12298857,12305063,12301960,6206
41,Chr2,13493572,13495247,13494410,1675
41,Chr2,15075195,15077841,15076518,2646
41,Chr3,314949,315075,315012,126
41,Chr3,3254469,3279079,3266774,24610
41,Chr4,1004782,1005106,1004944,324
41,Chr4,1477959,1478004,1477981,45
41,Chr5,1933544,1933632,1933588,88
41,Chr5,2839059,2840553,2839806,1494
41,Chr5,4555268,4555431,4555350,163
41,Chr5,16944022,16944291,16944156,269
41,Chr5,18215511,18216191,18215851,680
41,Chr5,25356567,25357125,25356846,558
41,Chr5,25990921,25991503,25991212,582
42,Chr1,2705311,2706084,2705697,773
42,Chr1,5772482,5772627,5772554,145
42,Chr1,24477151,24478100,24477625,949
42,Chr2,306404,306436,306420,32
42,Chr2,8140037,8168512,8154275,28475
42,Chr2,12133288,12133874,12133581,586
42,Chr2,15055505,15055656,15055581,151
42,Chr3,4138125,4139095,4138610,970
42,Chr3,11106273,11106349,11106311,76
42,Chr3,21392487,21397021,21394754,4534
42,Chr3,22378209,22378888,22378549,679
42,Chr4,1212578,1213118,1212848,540
42,Chr4,7849216,7849338,7849277,122
42,Chr5,1611199,1611280,1611239,81
42,Chr5,2191155,2191851,2191503,696
42,Chr5,3337916,3339170,3338543,1254
42,Chr5,21284432,21285263,21284848,831
42,Chr5,23059314,23059560,23059437,246
43,Chr1,292520,292574,292547,54
43,Chr1,5688419,5689169,5688794,750
43,Chr1,8461734,8465804,8463769,4070
43,Chr1,16471791,16471958,16471875,167
43,Chr2,8011827,8013963,8012895,2136
43,Chr2,10558471,10558972,10558721,501
43,Chr2,13158787,13159390,13159089,603
43,Chr2,14642785,14643012,14642899,227
43,Chr2,15781912,15782815,15782364,903
43,Chr2,18736028,18736334,18736181,306
43,Chr3,4367690,4368689,4368190,999
43,Chr3,6163908,6164046,6163977,138
43,Chr3,6779954,6780337,6780146,383
43,Chr3,19633795,19637216,19635505,3421
43,Chr3,20435162,20435197,20435180,35
43,Chr4,10964578,10964733,10964656,155
43,Chr4,13981691,13983005,13982348,1314
43,Chr5,2938597,2940277,2939437,1680
43,Chr5,19693732,19699866,19696799,6134
43,Chr5,22203567,22204077,22203822,510
43,Chr5,24103005,24103794,24103399,789
44,Chr1,2689107,2693300,2691203,4193
44,Chr2,826572,827159,826866,587
44,Chr2,12578744,12579034,12578889,290
44,Chr2,17742758,17743772,17743265,1014
44,Chr3,6673441,6675329,6674385,1888
44,Chr3,21123015,21123071,21123043,56
44,Chr3,23357343,23357645,23357494,302
44,Chr4,7035497,7036002,7035749,505
44,Chr4,11620046,11620461,11620254,415
44,Chr4,12109067,12109090,12109079,23
44,Chr5,4155231,4156033,4155632,802
44,Chr5,14065285,14065347,14065316,62
44,Chr5,23041004,23041510,23041257,506
45,Chr1,5349539,5349766,5349653,227
45,Chr1,7407649,7408557,7408103,908
45,Chr1,10880452,10880589,10880520,137
45,Chr1,12369372,12370126,12369749,754
45,Chr1,20787190,20787979,20787584,789
45,Chr1,25166532,25166721,25166626,189
45,Chr2,10216306,10216454,10216380,148
45,Chr2,13320871,13321516,13321193,645
45,Chr2,17365333,17365717,17365525,384
45,Chr2,18806375,18806519,18806447,144
45,Chr3,6432741,6434345,6433543,1604
45,Chr3,7040536,7044650,7042593,4114
45,Chr3,7820341,7820461,7820401,120
45,Chr3,9711952,9712078,9712015,126
45,Chr3,18012644,18012859,18012752,215
45,Chr3,19230189,19230323,19230256,134
45,Chr3,20965128,20966251,20965690,1123
45,Chr3,21639679,21656386,21648033,16707
45,Chr4,1510394,1511512,1510953,1118
45,Chr4,6832169,6832334,6832251,165
45,Chr4,7305435,7306232,7305833,797
45,Chr5,16613252,16616120,16614686,2868
45,Chr5,26470877,26471225,26471051,348
46,Chr1,4373233,4374375,4373804,1142
46,Chr1,5858134,5859075,5858604,941
46,Chr1,28639354,28639587,28639470,233
46,Chr1,29182881,29183103,29182992,222
46,Chr2,811008,812905,811956,1897
46,Chr2,10848903,10850192,10849547,1289
46,Chr2,12022648,12104379,12063514,81731
46,Chr2,15344588,15345299,15344944,711
46,Chr2,16710092,16710398,16710245,306
46,Chr2,19484182,19484867,19484524,685
46,Chr3,2365361,2366785,2366073,1424
46,Chr3,3350888,3351064,3350976,176
46,Chr3,10375988,10376152,10376070,164
46,Chr3,18427164,18428383,18427774,1219
46,Chr4,1252017,1253047,1252532,1030
46,Chr4,4841999,4842347,4842173,348
46,Chr4,9031146,9031710,9031428,564
46,Chr4,10275009,10275283,10275146,274
46,Chr4,13234575,13235021,13234798,446
46,Chr4,13676843,13677531,13677187,688
46,Chr4,13820624,13823571,13822098,2947
46,Chr4,16136771,16136819,16136795,48
46,Chr4,16874587,16878040,16876313,3453
46,Chr5,1235020,1235284,1235152,264
46,Chr5,2565171,2565299,2565235,128
46,Chr5,6709479,6710100,6709789,621
46,Chr5,9265577,9268197,9266887,2620
46,Chr5,10615560,10615657,10615608,97
46,Chr5,14196896,14199322,14198109,2426
46,Chr5,16834584,16835194,16834889,610
46,Chr5,19248527,19248831,19248679,304
46,Chr5,21654906,21655322,21655114,416
46,Chr5,25705167,25706307,25705737,1140
47,Chr1,1111666,1112596,1112131,930
47,Chr1,6332643,6334302,6333473,1659
47,Chr1,20159040,20159574,20159307,534
47,Chr1,22917303,22917547,22917425,244
47,Chr1,26648151,26648397,26648274,246
47,Chr1,27330812,27331541,27331176,729
47,Chr1,29149094,29150060,29149577,966
47,Chr2,10363378,10367122,10365250,3744
47,Chr2,14317638,14318715,14318176,1077
47,Chr2,18025158,18025694,18025426,536
47,Chr3,120693,121074,120883,381
47,Chr3,2173384,2174734,2174059,1350
47,Chr3,3313590,3334922,3324256,21332
47,Chr3,10734344,10734466,10734405,122
47,Chr4,8474301,8474592,8474447,291
47,Chr4,8515841,8520598,8518219,4757
47,Chr4,9949613,9950358,9949985,745
47,Chr5,2484101,2484389,2484245,288
47,Chr5,4457409,4457672,4457541,263
47,Chr5,7185090,7185159,7185124,69
47,Chr5,9268397,9268822,9268609,425
47,Chr5,16518225,16518537,16518381,312
47,Chr5,21011340,21011471,21011406,131
47,Chr5,21788525,21796194,21792359,7669
47,Chr5,26455109,26455928,26455519,819
47,Chr5,26647439,26648072,26647755,633
48,Chr1,650324,650855,650590,531
48,Chr1,4038857,4039186,4039021,329
48,Chr1,5125595,5127261,5126428,1666
48,Chr1,6635063,6635717,6635390,654
48,Chr2,1056377,1056645,1056511,268
48,Chr2,8175330,8175382,8175356,52
48,Chr2,8791773,8792523,8792148,750
48,Chr2,10313875,10314432,10314153,557
48,Chr2,12922351,12922417,12922384,66
48,Chr2,13818817,13819061,13818939,244
48,Chr2,14771775,14776116,14773945,4341
48,Chr2,15348060,15348930,15348495,870
48,Chr3,828799,829696,829247,897
48,Chr3,1457237,1457333,1457285,96
48,Chr3,2989884,2991631,2990758,1747
48,Chr3,9835667,9836293,9835980,626
48,Chr3,15986348,15987507,15986928,1159
48,Chr3,20765174,20765570,20765372,396
48,Chr4,7131904,7132086,7131995,182
48,Chr4,7560724,7560936,7560830,212
48,Chr4,10005199,10006303,10005751,1104
48,Chr4,11899427,11899582,11899505,155
48,Chr4,12575116,12575728,12575422,612
48,Chr5,4898981,4900514,4899747,1533
48,Chr5,7562400,7562412,7562406,12
48,Chr5,10290889,10291106,10290997,217
48,Chr5,19149904,19150090,19149997,186
48,Chr5,26695731,26695832,26695781,101
49,Chr1,1995128,1995260,1995194,132
49,Chr1,2878963,2879396,2879179,433
49,Chr1,8127527,8128241,8127884,714
49,Chr1,11621473,11621810,11621641,337
49,Chr1,20691083,20691336,20691209,253
49,Chr1,25740148,25742572,25741360,2424
49,Chr1,27882729,27883500,27883115,771
49,Chr1,28275118,28275421,28275270,303
49,Chr1,30300471,30300501,30300486,30
49,Chr2,621943,623192,622567,1249
49,Chr2,9267057,9267374,9267215,317
49,Chr2,14209711,14210718,14210215,1007
49,Chr2,17562486,17563717,17563102,1231
49,Chr2,18339732,18340141,18339936,409
49,Chr3,888042,888150,888096,108
49,Chr3,4466960,4467307,4467134,347
49,Chr3,6925883,6929981,6927932,4098
49,Chr3,22313742,22314051,22313896,309
49,Chr4,932124,932431,932278,307
49,Chr4,10100764,10102889,10101826,2125
49,Chr4,12769256,12769558,12769407,302
49,Chr4,14496442,14496821,14496632,379
49,Chr5,1896054,1900974,1898514,4920
49,Chr5,4673476,4673781,4673628,305
49,Chr5,7946836,7947412,7947124,576
49,Chr5,23119076,23144398,23131737,25322
49,Chr5,24904850,24905029,24904940,179
49,Chr5,25645956,25646145,25646050,189
49,Chr5,26129542,26130152,26129847,610
49,Chr5,26764042,26764716,26764379,674
5,Chr1,1817775,1819235,1818505,1460
5,Chr1,5316506,5317663,5317084,1157
5,Chr1,8144187,8144355,8144271,168
5,Chr1,10971305,10971439,10971372,134
5,Chr1,22216114,22216169,22216142,55
5,Chr1,25445189,25445501,25445345,312
5,Chr1,29362802,29363120,29362961,318
5,Chr2,428429,428541,428485,112
5,Chr2,13127258,13137294,13132276,10036
5,Chr2,14566059,14566506,14566283,447
5,Chr3,15865243,15865377,15865310,134
5,Chr3,17638540,17638553,17638546,13
5,Chr3,21099706,21099982,21099844,276
5,Chr4,142055,142943,142499,888
5,Chr4,1520728,1520992,1520860,264
5,Chr4,11461511,11462128,11461819,617
5,Chr4,11971608,11971657,11971632,49
5,Chr4,17249741,17250169,17249955,428
5,Chr4,17660259,17660747,17660503,488
5,Chr4,18177419,18178128,18177773,709
5,Chr5,2623157,2623365,2623261,208
5,Chr5,4574136,4574473,4574304,337
5,Chr5,5436897,5437006,5436951,109
5,Chr5,6340561,6341311,6340936,750
5,Chr5,7376941,7377849,7377395,908
5,Chr5,7956486,7958580,7957533,2094
5,Chr5,16739235,16739641,16739438,406
5,Chr5,19342075,19342272,19342173,197
5,Chr5,22198844,22199841,22199342,997
5,Chr5,23357563,23358010,23357787,447
5,Chr5,26878450,26878508,26878479,58
50,Chr1,2403720,2404671,2404196,951
50,Chr1,3084103,3088287,3086195,4184
50,Chr1,5008849,5021513,5015181,12664
50,Chr1,8474049,8474676,8474363,627
50,Chr1,18920429,19007991,18964210,87562
50,Chr1,22033521,22033956,22033739,435
50,Chr1,23783236,23783673,23783454,437
50,Chr1,27467089,27468843,27467966,1754
50,Chr2,12617076,12617178,12617127,102
50,Chr2,16705075,16705595,16705335,520
50,Chr3,1106716,1108150,1107433,1434
50,Chr3,1551351,1552349,1551850,998
50,Chr3,4219557,4220738,4220147,1181
50,Chr4,10463921,10464058,10463989,137
50,Chr5,1491157,1491598,1491377,441
50,Chr5,2781614,2782334,2781974,720
50,Chr5,8695591,8696192,8695891,601
50,Chr5,26855753,26855815,26855784,62
51,Chr1,117592,119083,118338,1491
51,Chr1,4149303,4149361,4149332,58
51,Chr1,13036123,13039224,13037673,3101
51,Chr1,17867406,17871209,17869308,3803
51,Chr1,19007704,19007991,19007848,287
51,Chr1,20216902,20216964,20216933,62
51,Chr1,22005169,22006406,22005787,1237
51,Chr1,27182361,27182818,27182589,457
51,Chr2,6521112,6521990,6521551,878
51,Chr2,17220925,17220993,17220959,68
51,Chr2,18049478,18049931,18049704,453
51,Chr3,1484491,1484602,1484547,111
51,Chr3,3224228,3225051,3224640,823
51,Chr3,5142262,5156156,5149209,13894
51,Chr3,5860008,5860291,5860150,283
51,Chr3,9772007,9775630,9773819,3623
51,Chr3,11299286,11299502,11299394,216
51,Chr3,15568841,15569055,15568948,214
51,Chr3,20363008,20363925,20363466,917
51,Chr4,483253,483595,483424,342
51,Chr4,18541272,18541351,18541312,79
51,Chr5,2840553,2847703,2844128,7150
51,Chr5,3532144,3534112,3533128,1968
51,Chr5,6496399,6498208,6497303,1809
51,Chr5,18151378,18151778,18151578,400
51,Chr5,21844129,21844171,21844150,42
51,Chr5,26646140,26646418,26646279,278
52,Chr1,2625164,2625206,2625185,42
52,Chr1,4071537,4074834,4073185,3297
52,Chr1,4906997,4908188,4907593,1191
52,Chr1,10214311,10214381,10214346,70
52,Chr1,18424688,18424921,18424804,233
52,Chr1,24332498,24334880,24333689,2382
52,Chr1,26430280,26430724,26430502,444
52,Chr1,27837291,27837509,27837400,218
52,Chr2,6538133,6538184,6538159,51
52,Chr2,11326009,11326131,11326070,122
52,Chr2,13584287,13586710,13585499,2423
52,Chr2,15946197,15947034,15946615,837
52,Chr2,17688492,17688877,17688684,385
52,Chr2,19020014,19020654,19020334,640
52,Chr3,6303569,6303715,6303642,146
52,Chr3,12773719,12773875,12773797,156
52,Chr3,14763733,14763896,14763815,163
52,Chr4,13408431,13409068,13408749,637
52,Chr4,18315277,18315721,18315499,444
52,Chr5,301145,301689,301417,544
52,Chr5,778979,779178,779079,199
52,Chr5,2897676,2900007,2898842,2331
52,Chr5,5073133,5122196,5097665,49063
52,Chr5,8740321,8740628,8740475,307
52,Chr5,13655940,13656828,13656384,888
52,Chr5,18682941,18683425,18683183,484
52,Chr5,21780950,21797094,21789022,16144
52,Chr5,23226922,23226975,23226948,53
52,Chr5,26770982,26771186,26771084,204
53,Chr1,1199647,1200321,1199984,674
53,Chr1,2803229,2805328,2804279,2099
53,Chr1,4032248,4032619,4032434,371
53,Chr1,6563107,6564527,6563817,1420
53,Chr1,7090193,7090396,7090295,203
53,Chr1,18386107,18388169,18387138,2062
53,Chr2,1702457,1702692,1702575,235
53,Chr2,7047500,7047766,7047633,266
53,Chr2,10216454,10217368,10216911,914
53,Chr2,11927150,11928046,11927598,896
53,Chr2,16261253,16261498,16261375,245
53,Chr2,17527940,17529372,17528656,1432
53,Chr2,19603306,19606040,19604673,2734
53,Chr3,2139551,2140410,2139981,859
53,Chr3,3028817,3029642,3029229,825
53,Chr3,5841869,5842670,5842269,801
53,Chr3,22360715,22360882,22360799,167
53,Chr4,1535651,1536382,1536017,731
53,Chr4,6786168,6786403,6786286,235
53,Chr4,8513765,8514392,8514079,627
53,Chr4,11770092,11770174,11770133,82
53,Chr4,13171076,13172435,13171756,1359
53,Chr4,13832324,13838058,13835191,5734
53,Chr5,916699,919743,918221,3044
53,Chr5,1989825,1991286,1990555,1461
53,Chr5,2860588,2860735,2860662,147
53,Chr5,4192827,4194804,4193815,1977
53,Chr5,4558750,4558922,4558836,172
53,Chr5,5010493,5010560,5010527,67
53,Chr5,5526979,5536093,5531536,9114
53,Chr5,13461989,13462497,13462243,508
53,Chr5,16089430,16090527,16089978,1097
53,Chr5,25447525,25448167,25447846,642
53,Chr5,26037543,26037580,26037561,37
54,Chr1,2436519,2438714,2437617,2195
54,Chr1,3934410,3938146,3936278,3736
54,Chr1,7375734,7375874,7375804,140
54,Chr1,17615900,17616013,17615956,113
54,Chr1,20669794,20670775,20670284,981
54,Chr1,27942804,27943432,27943118,628
54,Chr1,29301458,29308227,29304842,6769
54,Chr2,1184867,1186486,1185677,1619
54,Chr2,9525983,9525997,9525990,14
54,Chr2,11310215,11310270,11310243,55
54,Chr3,37066,38702,37884,1636
54,Chr3,1421403,1421525,1421464,122
54,Chr3,5645637,5646444,5646041,807
54,Chr3,21200289,21202049,21201169,1760
54,Chr4,9751450,9751728,9751589,278
54,Chr5,4272083,4273424,4272753,1341
54,Chr5,4891006,4891935,4891470,929
54,Chr5,22195997,22197529,22196763,1532
54,Chr5,25343082,25343090,25343086,8
55,Chr1,372675,377064,374869,4389
55,Chr1,834960,844413,839686,9453
55,Chr1,1545929,1547573,1546751,1644
55,Chr1,4265867,4266002,4265935,135
55,Chr1,5116528,5116659,5116594,131
55,Chr1,9499987,9501125,9500556,1138
55,Chr1,13126249,13126490,13126369,241
55,Chr1,16453848,16460839,16457344,6991
55,Chr1,21202178,21204387,21203282,2209
55,Chr1,27652407,27652763,27652585,356
55,Chr2,1934733,1934834,1934783,101
55,Chr2,10414316,10415998,10415157,1682
55,Chr2,15092383,15092846,15092615,463
55,Chr2,15701439,15702754,15702097,1315
55,Chr3,1018831,1019521,1019176,690
55,Chr3,4102643,4103514,4103079,871
55,Chr3,19571827,19572191,19572009,364
55,Chr3,22248040,22248470,22248255,430
55,Chr3,23203568,23207236,23205402,3668
55,Chr4,6286001,6287156,6286579,1155
55,Chr4,12067931,12069182,12068557,1251
55,Chr5,5056405,5058425,5057415,2020
55,Chr5,8112033,8112079,8112056,46
55,Chr5,8696192,8697269,8696730,1077
55,Chr5,9793112,9793385,9793248,273
55,Chr5,16073882,16074111,16073996,229
55,Chr5,22277559,22278703,22278131,1144
55,Chr5,24921180,24921991,24921586,811
55,Chr5,25327277,25328302,25327789,1025
56,Chr1,159434,159941,159688,507
56,Chr1,309787,314437,312112,4650
56,Chr1,4029763,4030377,4030070,614
56,Chr1,7989861,7991401,7990631,1540
56,Chr1,10500499,10501212,10500855,713
56,Chr1,20736334,20736398,20736366,64
56,Chr1,26529190,26529743,26529466,553
56,Chr1,27571325,27572071,27571698,746
56,Chr2,190900,191007,190954,107
56,Chr2,14426243,14426540,14426391,297
56,Chr3,5633774,5633896,5633835,122
56,Chr3,6222964,6224042,6223503,1078
56,Chr3,7394284,7397662,7395973,3378
56,Chr3,22787954,22788175,22788064,221
56,Chr4,11350939,11351704,11351321,765
56,Chr4,12990407,12990508,12990457,101
56,Chr5,3070749,3071064,3070907,315
56,Chr5,4944795,4945797,4945296,1002
56,Chr5,8943719,8943873,8943796,154
56,Chr5,15976679,15977286,15976983,607
56,Chr5,17652785,17653035,17652910,250
56,Chr5,25458194,25458236,25458215,42
56,Chr5,26249971,26250065,26250018,94
57,Chr1,2852039,2857210,2854625,5171
57,Chr1,8431284,8431404,8431344,120
57,Chr1,9213916,9214342,9214129,426
57,Chr1,20031124,20031267,20031196,143
57,Chr2,8169884,8169986,8169935,102
57,Chr2,8705632,8706653,8706142,1021
57,Chr2,9541565,9543440,9542503,1875
57,Chr2,13786537,13786619,13786578,82
57,Chr2,14344966,14345773,14345370,807
57,Chr2,15069413,15069470,15069441,57
57,Chr2,19112761,19114650,19113705,1889
57,Chr3,649418,650206,649812,788
57,Chr3,1257882,1258224,1258053,342
57,Chr3,8177554,8177623,8177588,69
57,Chr3,8801700,8802716,8802208,1016
57,Chr3,18422098,18423143,18422620,1045
57,Chr3,19295659,19299801,19297730,4142
57,Chr4,553360,561220,557290,7860
57,Chr4,1023562,1027159,1025360,3597
57,Chr4,7736737,7736902,7736819,165
57,Chr4,10819612,10819944,10819778,332
57,Chr4,13021522,13022136,13021829,614
57,Chr4,18396235,18401190,18398713,4955
57,Chr5,2194569,2194626,2194597,57
57,Chr5,7393564,7395451,7394508,1887
57,Chr5,15573105,15573164,15573135,59
57,Chr5,21252223,21255341,21253782,3118
57,Chr5,25559811,25559933,25559872,122
58,Chr1,6548887,6552008,6550447,3121
58,Chr1,9647745,9648267,9648006,522
58,Chr1,20109525,20109718,20109621,193
58,Chr1,29919601,29920199,29919900,598
58,Chr2,6893169,6893212,6893191,43
58,Chr2,7337862,7337949,7337906,87
58,Chr2,8147864,8168512,8158188,20648
58,Chr2,11150413,11150486,11150449,73
58,Chr2,11672459,11673741,11673100,1282
58,Chr2,12012136,12014757,12013446,2621
58,Chr2,13372383,13372682,13372533,299
58,Chr2,14464060,14464503,14464282,443
58,Chr2,15840952,15840982,15840967,30
58,Chr2,19486493,19486667,19486580,174
58,Chr3,7102631,7103603,7103117,972
58,Chr3,19852471,19853216,19852843,745
58,Chr3,21681549,21683115,21682332,1566
58,Chr4,8679975,8680165,8680070,190
58,Chr5,537064,537261,537162,197
58,Chr5,1795989,1796716,1796353,727
58,Chr5,8796203,8799898,8798051,3695
58,Chr5,14066392,14067592,14066992,1200
58,Chr5,23939829,23940687,23940258,858
59,Chr1,2278961,2279907,2279434,946
59,Chr1,5614077,5616158,5615117,2081
59,Chr1,11219367,11219610,11219489,243
59,Chr1,26735844,26737672,26736758,1828
59,Chr1,30266564,30267370,30266967,806
59,Chr2,10313875,10314432,10314153,557
59,Chr2,13215340,13215665,13215502,325
59,Chr2,15195216,15195610,15195413,394
59,Chr3,2605772,2607353,2606562,1581
59,Chr3,18513701,18514112,18513907,411
59,Chr3,22008705,22009399,22009052,694
59,Chr4,8384315,8384660,8384487,345
59,Chr4,11660886,11661989,11661438,1103
59,Chr5,2856669,2857244,2856957,575
59,Chr5,8600801,8600997,8600899,196
59,Chr5,9294907,9296241,9295574,1334
59,Chr5,20326794,20327983,20327388,1189
59,Chr5,22047618,22047965,22047792,347
59,Chr5,22735892,22738563,22737228,2671
59,Chr5,26291286,26291496,26291391,210
6,Chr1,7666089,7666363,7666226,274
6,Chr1,10498135,10498575,10498355,440
6,Chr1,26218639,26219848,26219243,1209
6,Chr1,30151003,30152255,30151629,1252
6,Chr2,10612253,10612313,10612283,60
6,Chr2,12783194,12783385,12783290,191
6,Chr2,18126946,18131925,18129436,4979
6,Chr2,19502604,19502787,19502696,183
6,Chr3,596737,596943,596840,206
6,Chr3,1834881,1836247,1835564,1366
6,Chr3,2928053,2928239,2928146,186
6,Chr3,4083614,4083766,4083690,152
6,Chr3,10301599,10302313,10301956,714
6,Chr3,16841345,16842961,16842153,1616
6,Chr3,21247821,21250228,21249025,2407
6,Chr3,22321970,22322299,22322134,329
6,Chr4,249498,250119,249808,621
6,Chr4,13004008,13004050,13004029,42
6,Chr4,18466872,18467261,18467066,389
6,Chr5,17781875,17782603,17782239,728
6,Chr5,24890953,24892658,24891805,1705
6,Chr5,26911906,26912269,26912088,363
60,Chr1,129671,129841,129756,170
60,Chr1,582876,583717,583296,841
60,Chr1,6949437,6950137,6949787,700
60,Chr1,8920662,8920715,8920688,53
60,Chr1,11679228,11679427,11679328,199
60,Chr1,17353621,17353967,17353794,346
60,Chr1,20259997,20276105,20268051,16108
60,Chr1,20711571,20711624,20711597,53
60,Chr1,25219023,25220385,25219704,1362
60,Chr2,7203738,7203924,7203831,186
60,Chr2,16761657,16763799,16762728,2142
60,Chr2,17164717,17164784,17164751,67
60,Chr2,17240281,17240518,17240399,237
60,Chr2,17728029,17728288,17728159,259
60,Chr2,18486098,18486285,18486192,187
60,Chr3,5371646,5372409,5372028,763
60,Chr3,19995982,19996747,19996364,765
60,Chr3,21708630,21711566,21710098,2936
60,Chr4,10709123,10710660,10709891,1537
60,Chr4,13482481,13485656,13484069,3175
60,Chr5,1049079,1049949,1049514,870
60,Chr5,3609944,3613652,3611798,3708
60,Chr5,4196003,4197840,4196921,1837
60,Chr5,14873667,14873792,14873729,125
60,Chr5,17098352,17098475,17098414,123
60,Chr5,17594695,17594794,17594745,99
60,Chr5,23144398,23158346,23151372,13948
61,Chr1,605448,606019,605734,571
61,Chr1,2753088,2753410,2753249,322
61,Chr1,6006468,6008459,6007464,1991
61,Chr1,7814158,7814366,7814262,208
61,Chr1,9965330,9966403,9965866,1073
61,Chr1,11908372,11914409,11911390,6037
61,Chr1,13122864,13123176,13123020,312
61,Chr1,22683611,22684430,22684021,819
61,Chr1,27995475,27996219,27995847,744
61,Chr1,28844221,28844408,28844315,187
61,Chr1,30347657,30348549,30348103,892
61,Chr2,106907,107058,106983,151
61,Chr2,7568551,7569530,7569041,979
61,Chr2,8434699,8435320,8435009,621
61,Chr2,15070544,15070848,15070696,304
61,Chr2,15847936,15848734,15848335,798
61,Chr2,16694743,16695529,16695136,786
61,Chr2,19620438,19621921,19621180,1483
61,Chr3,2656823,2656945,2656884,122
61,Chr3,6914909,6929981,6922445,15072
61,Chr3,19230189,19230323,19230256,134
61,Chr4,6271320,6272017,6271668,697
61,Chr4,7138273,7138412,7138343,139
61,Chr4,8051040,8051498,8051269,458
61,Chr4,11995362,11995818,11995590,456
61,Chr5,1095575,1095922,1095749,347
61,Chr5,3871424,3881347,3876386,9923
61,Chr5,7230521,7230701,7230611,180
61,Chr5,16517633,16517760,16517697,127
61,Chr5,19221496,19222031,19221764,535
61,Chr5,24354656,24357302,24355979,2646
61,Chr5,25996542,25997171,25996856,629
62,Chr1,850465,858097,854281,7632
62,Chr1,8974635,8974855,8974745,220
62,Chr1,10703041,10704356,10703699,1315
62,Chr1,17977856,17977946,17977901,90
62,Chr1,25456162,25457003,25456582,841
62,Chr1,28574710,28575896,28575303,1186
62,Chr2,16710398,16710559,16710478,161
62,Chr3,5182864,5203184,5193024,20320
62,Chr3,8669167,8670846,8670007,1679
62,Chr3,9992587,9992714,9992651,127
62,Chr3,20759978,20760227,20760102,249
62,Chr3,23281939,23282555,23282247,616
62,Chr4,1174782,1175430,1175106,648
62,Chr4,9046796,9048298,9047547,1502
62,Chr4,18067546,18067679,18067612,133
62,Chr5,9476005,9476372,9476189,367
62,Chr5,10301025,10301667,10301346,642
62,Chr5,25618132,25618583,25618358,451
63,Chr1,1110391,1110852,1110621,461
63,Chr1,8378074,8378415,8378244,341
63,Chr1,19685636,19686049,19685842,413
63,Chr1,21516733,21517951,21517342,1218
63,Chr2,231713,232085,231899,372
63,Chr2,1136930,1137220,1137075,290
63,Chr2,6035326,6035766,6035546,440
63,Chr2,8544356,8544873,8544614,517
63,Chr2,11622825,11623150,11622987,325
63,Chr2,13611029,13611148,13611089,119
63,Chr2,14320948,14321254,14321101,306
63,Chr2,15522646,15522697,15522672,51
63,Chr3,424844,424898,424871,54
63,Chr3,2127100,2129367,2128234,2267
63,Chr3,3232390,3239938,3236164,7548
63,Chr3,5016884,5017099,5016992,215
63,Chr3,7453736,7453883,7453810,147
63,Chr3,7929647,7930051,7929849,404
63,Chr3,8598794,8598952,8598873,158
63,Chr3,9838140,9838715,9838428,575
63,Chr3,21028155,21028268,21028211,113
63,Chr3,23194373,23195662,23195017,1289
63,Chr4,1180313,1180373,1180343,60
63,Chr4,11275597,11275614,11275605,17
63,Chr4,18507588,18507910,18507749,322
63,Chr5,859838,862362,861100,2524
63,Chr5,1329987,1332190,1331089,2203
63,Chr5,1762648,1762804,1762726,156
63,Chr5,2386288,2387407,2386848,1119
63,Chr5,3692575,3693139,3692857,564
63,Chr5,5465154,5466480,5465817,1326
63,Chr5,5936322,5936598,5936460,276
63,Chr5,7085307,7085587,7085447,280
63,Chr5,7187828,7188106,7187967,278
63,Chr5,14656609,14656662,14656635,53
63,Chr5,20099499,20099697,20099598,198
63,Chr5,21265694,21266002,21265848,308
63,Chr5,21710645,21711431,21711038,786
63,Chr5,26593780,26595721,26594750,1941
64,Chr1,489092,523868,506480,34776
64,Chr1,1739832,1739947,1739890,115
64,Chr1,3284563,3284814,3284689,251
64,Chr1,5423997,5424153,5424075,156
64,Chr1,10222415,10262456,10242435,40041
64,Chr1,18109651,18110326,18109989,675
64,Chr1,18907314,18907380,18907347,66
64,Chr1,19790846,19792197,19791522,1351
64,Chr1,21927802,21929324,21928563,1522
64,Chr1,26433298,26434062,26433680,764
64,Chr1,28307408,28309451,28308430,2043
64,Chr2,12392142,12393162,12392652,1020
64,Chr2,13277113,13277594,13277353,481
64,Chr2,17876270,17876674,17876472,404
64,Chr3,1358065,1359868,1358967,1803
64,Chr3,2205954,2206030,2205992,76
64,Chr3,6283099,6283256,6283177,157
64,Chr3,6778178,6779954,6779066,1776
64,Chr3,10118510,10120730,10119620,2220
64,Chr3,18578492,18578559,18578526,67
64,Chr3,19105656,19108287,19106972,2631
64,Chr4,143460,143674,143567,214
64,Chr4,568179,568203,568191,24
64,Chr4,1131747,1134041,1132894,2294
64,Chr4,7761430,7761773,7761602,343
64,Chr4,9024362,9025093,9024728,731
64,Chr5,1705045,1706021,1705533,976
64,Chr5,2692377,2692455,2692416,78
64,Chr5,3476215,3476740,3476477,525
64,Chr5,7079670,7079857,7079764,187
64,Chr5,19680119,19680548,19680333,429
64,Chr5,25722531,25722960,25722745,429
65,Chr1,452718,453167,452942,449
65,Chr1,453167,453280,453223,113
65,Chr1,2852039,2857210,2854625,5171
65,Chr1,4232928,4233098,4233013,170
65,Chr1,5070376,5072878,5071627,2502
65,Chr1,7915244,7915582,7915413,338
65,Chr1,8863836,8864516,8864176,680
65,Chr1,9797952,9800230,9799091,2278
65,Chr1,11338656,11338761,11338708,105
65,Chr1,18029116,18029270,18029193,154
65,Chr2,6806525,6807863,6807194,1338
65,Chr2,9701398,9701557,9701478,159
65,Chr2,11253149,11253287,11253218,138
65,Chr2,11830894,11831771,11831332,877
65,Chr2,12374475,12374651,12374563,176
65,Chr2,14538349,14541408,14539879,3059
65,Chr2,16949641,16951877,16950759,2236
65,Chr2,17479573,17481679,17480626,2106
65,Chr2,18311539,18311644,18311591,105
65,Chr3,2102997,2103689,2103343,692
65,Chr3,2341347,2341774,2341561,427
65,Chr3,5257673,5257933,5257803,260
65,Chr3,7917216,7919324,7918270,2108
65,Chr3,11961213,11961351,11961282,138
65,Chr3,19685890,19686236,19686063,346
65,Chr3,20383518,20383752,20383635,234
65,Chr3,20398415,20399377,20398896,962
65,Chr3,22470860,22473321,22472090,2461
65,Chr3,23024994,23025546,23025270,552
65,Chr4,427863,428297,428080,434
65,Chr4,915993,918082,917037,2089
65,Chr4,10399964,10400371,10400168,407
65,Chr4,11314377,11314822,11314599,445
65,Chr4,11968427,11969171,11968799,744
65,Chr5,844950,845430,845190,480
65,Chr5,1343884,1344131,1344008,247
65,Chr5,2500372,2500572,2500472,200
65,Chr5,4201264,4201810,4201537,546
65,Chr5,9815720,9816863,9816292,1143
65,Chr5,22088122,22088174,22088148,52
65,Chr5,22844751,22844880,22844815,129
65,Chr5,25193990,25194716,25194353,726
65,Chr5,26907966,26908227,26908096,261
66,Chr1,850465,858097,854281,7632
66,Chr1,4228259,4230063,4229161,1804
66,Chr1,11817635,11818812,11818223,1177
66,Chr1,19602372,19604495,19603434,2123
66,Chr1,25419673,25420351,25420012,678
66,Chr2,493537,493650,493593,113
66,Chr2,14728458,14730392,14729425,1934
66,Chr3,4825221,4826877,4826049,1656
66,Chr3,7540031,7540482,7540257,451
66,Chr3,17790964,17791091,17791028,127
66,Chr3,18304669,18306828,18305749,2159
66,Chr3,19903841,19903862,19903851,21
66,Chr4,8505063,8505840,8505451,777
66,Chr4,10485352,10486021,10485686,669
66,Chr5,2439774,2440832,2440303,1058
66,Chr5,14619756,14620154,14619955,398
66,Chr5,22599233,22602033,22600633,2800
66,Chr5,24782565,24785378,24783971,2813
67,Chr1,3654196,3655063,3654630,867
67,Chr1,6394402,6395981,6395192,1579
67,Chr1,7911663,7912076,7911869,413
67,Chr1,19796813,19796897,19796855,84
67,Chr1,23903502,23903886,23903694,384
67,Chr1,27429492,27430330,27429911,838
67,Chr1,27867917,27869924,27868921,2007
67,Chr1,28823928,28826609,28825268,2681
67,Chr2,7325820,7326174,7325997,354
67,Chr2,9667203,9667370,9667287,167
67,Chr2,15228915,15228964,15228939,49
67,Chr2,17892211,17916319,17904265,24108
67,Chr3,1460881,1461869,1461375,988
67,Chr3,5803406,5803713,5803560,307
67,Chr3,9754374,9755185,9754780,811
67,Chr3,10287110,10299413,10293262,12303
67,Chr3,16446065,16446471,16446268,406
67,Chr3,19008810,19009151,19008980,341
67,Chr3,19864963,19868971,19866967,4008
67,Chr3,21240517,21241444,21240981,927
67,Chr4,11827468,11827972,11827720,504
67,Chr5,1400683,1400937,1400810,254
67,Chr5,5404257,5406334,5405295,2077
67,Chr5,20530269,20530688,20530479,419
67,Chr5,21030598,21031097,21030848,499
68,Chr1,5021513,5035603,5028558,14090
68,Chr1,7153166,7153779,7153472,613
68,Chr1,10207269,10207386,10207327,117
68,Chr1,10943834,10944048,10943941,214
68,Chr2,9400002,9400279,9400140,277
68,Chr2,14179917,14180070,14179993,153
68,Chr2,15014143,15014426,15014285,283
68,Chr2,15940160,15946197,15943178,6037
68,Chr2,16580442,16580516,16580479,74
68,Chr2,19492129,19492405,19492267,276
68,Chr3,4523118,4523347,4523232,229
68,Chr3,6281816,6281893,6281854,77
68,Chr3,9346716,9347051,9346884,335
68,Chr3,17387477,17387754,17387615,277
68,Chr3,18162749,18172911,18167830,10162
68,Chr4,7681466,7681810,7681638,344
68,Chr4,12714101,12714274,12714187,173
68,Chr5,4766376,4766736,4766556,360
68,Chr5,7844856,7844885,7844870,29
68,Chr5,13694269,13694299,13694284,30
68,Chr5,21978185,21978825,21978505,640
68,Chr5,25996542,25997171,25996856,629
68,Chr5,26855815,26856260,26856037,445
68,Chr5,26867665,26870208,26868937,2543
69,Chr1,180816,181261,181038,445
69,Chr1,19685182,19685636,19685409,454
69,Chr2,607842,608013,607928,171
69,Chr2,9242447,9243688,9243067,1241
69,Chr2,12922106,12922351,12922228,245
69,Chr2,14587968,14588212,14588090,244
69,Chr2,15211234,15213280,15212257,2046
69,Chr2,17943226,17951178,17947202,7952
69,Chr3,1575008,1575371,1575190,363
69,Chr3,3241867,3254469,3248168,12602
69,Chr3,3865907,3866020,3865963,113
69,Chr3,5694471,5694591,5694531,120
69,Chr3,7839717,7843011,7841364,3294
69,Chr3,15951705,15952384,15952045,679
69,Chr3,19703678,19704036,19703857,358
69,Chr3,20717539,20717640,20717589,101
69,Chr3,21521151,21541501,21531326,20350
69,Chr4,7732935,7733895,7733415,960
69,Chr4,9058968,9059405,9059186,437
69,Chr4,10945521,10945541,10945531,20
69,Chr4,12448855,12449164,12449009,309
69,Chr4,13864767,13867131,13865949,2364
69,Chr5,6725020,6725040,6725030,20
69,Chr5,7233943,7234648,7234295,705
69,Chr5,7732718,7735170,7733944,2452
69,Chr5,8589025,8589083,8589054,58
69,Chr5,16638872,16641348,16640110,2476
69,Chr5,20972660,20972713,20972686,53
69,Chr5,21016945,21017068,21017007,123
69,Chr5,22575163,22575516,22575339,353
7,Chr1,1771681,1772192,1771937,511
7,Chr1,2852039,2857210,2854625,5171
7,Chr1,16932029,16932855,16932442,826
7,Chr1,20983181,20983987,20983584,806
7,Chr1,29217780,29218968,29218374,1188
7,Chr1,30194723,30196438,30195581,1715
7,Chr2,362656,365116,363886,2460
7,Chr2,8474599,8474604,8474601,5
7,Chr2,8933950,8934514,8934232,564
7,Chr2,12001916,12002218,12002067,302
7,Chr2,14210718,14210981,14210850,263
7,Chr2,16505989,16507069,16506529,1080
7,Chr3,1359868,1360287,1360078,419
7,Chr3,3007742,3013021,3010382,5279
7,Chr3,7015774,7031492,7023633,15718
7,Chr3,21468762,21492444,21480603,23682
7,Chr4,5640821,5641241,5641031,420
7,Chr4,6632237,6632297,6632267,60
7,Chr4,12955360,12955670,12955515,310
7,Chr5,1367740,1367853,1367796,113
7,Chr5,2022503,2022625,2022564,122
7,Chr5,4225226,4225576,4225401,350
7,Chr5,7806915,7808129,7807522,1214
7,Chr5,23683263,23683991,23683627,728
7,Chr5,25157520,25159055,25158288,1535
7,Chr5,26510448,26511787,26511118,1339
70,Chr1,1288787,1382716,1335751,93929
70,Chr1,3160247,3160464,3160355,217
70,Chr1,28627318,28628667,28627992,1349
70,Chr2,9579108,9579247,9579178,139
70,Chr2,19229026,19233086,19231056,4060
70,Chr3,3982141,3986808,3984475,4667
70,Chr4,7222479,7222578,7222529,99
70,Chr4,9261360,9264189,9262774,2829
70,Chr4,11774383,11776120,11775251,1737
70,Chr5,3914246,3933074,3923660,18828
70,Chr5,4585505,4587944,4586725,2439
70,Chr5,5559677,5560556,5560117,879
70,Chr5,15929396,15929453,15929424,57
70,Chr5,22698593,22702919,22700756,4326
70,Chr5,23265414,23265707,23265560,293
70,Chr5,26599903,26600754,26600329,851
71,Chr1,3560980,3561504,3561242,524
71,Chr1,8103985,8104198,8104091,213
71,Chr1,8964684,8965939,8965312,1255
71,Chr1,19154775,19161501,19158138,6726
71,Chr1,21038296,21040574,21039435,2278
71,Chr1,24878671,24881377,24880024,2706
71,Chr1,28456198,28477388,28466793,21190
71,Chr2,7572000,7572047,7572024,47
71,Chr2,10775091,10775212,10775151,121
71,Chr2,11774844,11775343,11775094,499
71,Chr3,194501,195797,195149,1296
71,Chr3,5837176,5837329,5837252,153
71,Chr3,6442662,6445173,6443918,2511
71,Chr3,7912730,7913811,7913270,1081
71,Chr3,8474685,8475781,8475233,1096
71,Chr3,22428858,22429207,22429032,349
71,Chr4,767920,768202,768061,282
71,Chr4,7478904,7478976,7478940,72
71,Chr4,9677808,9678485,9678146,677
71,Chr5,3313727,3313783,3313755,56
71,Chr5,18540465,18540545,18540505,80
72,Chr1,922673,971198,946935,48525
72,Chr1,1726044,1727376,1726710,1332
72,Chr1,2936381,2941598,2938989,5217
72,Chr1,7948496,7950508,7949502,2012
72,Chr1,8689251,8692314,8690783,3063
72,Chr1,10547814,10548658,10548236,844
72,Chr1,12071578,12073267,12072422,1689
72,Chr1,12482689,12485833,12484261,3144
72,Chr1,23776762,23776922,23776842,160
72,Chr1,25511836,25531005,25521420,19169
72,Chr1,28141856,28144840,28143348,2984
72,Chr1,28936924,28937168,28937046,244
72,Chr2,6951588,6952651,6952120,1063
72,Chr2,12844417,12844596,12844507,179
72,Chr2,16644444,16644656,16644550,212
72,Chr2,19228809,19229026,19228917,217
72,Chr3,1251000,1251065,1251032,65
72,Chr3,3664317,3664440,3664379,123
72,Chr3,6163908,6164046,6163977,138
72,Chr3,6929981,6970532,6950257,40551
72,Chr3,10238531,10239728,10239129,1197
72,Chr3,23289645,23289698,23289671,53
72,Chr5,3219314,3219948,3219631,634
72,Chr5,4549975,4550376,4550175,401
72,Chr5,17788178,17788645,17788412,467
72,Chr5,21716982,21717721,21717352,739
73,Chr1,8864629,8864944,8864787,315
73,Chr1,8985127,8985456,8985291,329
73,Chr1,13340480,13350701,13345590,10221
73,Chr1,18970944,19007991,18989468,37047
73,Chr1,21001957,21004091,21003024,2134
73,Chr1,25385746,25386303,25386024,557
73,Chr1,26074497,26075443,26074970,946
73,Chr2,1564045,1564456,1564251,411
73,Chr2,12261886,12262792,12262339,906
73,Chr3,261101,261976,261539,875
73,Chr3,2200807,2200952,2200879,145
73,Chr3,3742411,3747604,3745007,5193
73,Chr3,5072740,5073728,5073234,988
73,Chr3,18413815,18414603,18414209,788
73,Chr3,19378467,19378660,19378563,193
73,Chr3,22398908,22399947,22399428,1039
73,Chr3,22784208,22784384,22784296,176
73,Chr4,7948703,7950135,7949419,1432
73,Chr4,12286011,12287371,12286691,1360
73,Chr5,2674022,2675587,2674804,1565
73,Chr5,5010089,5010222,5010155,133
73,Chr5,7888900,7889375,7889138,475
73,Chr5,17733675,17734507,17734091,832
73,Chr5,22671674,22672844,22672259,1170
73,Chr5,25895807,25896327,25896067,520
74,Chr1,6632320,6632795,6632558,475
74,Chr1,9924097,9924738,9924417,641
74,Chr1,23924121,23924236,23924179,115
74,Chr2,2240984,2241290,2241137,306
74,Chr2,2928762,2929980,2929371,1218
74,Chr2,12933390,12935819,12934604,2429
74,Chr2,15141949,15142113,15142031,164
74,Chr2,17917464,17918736,17918100,1272
74,Chr3,1056115,1056670,1056393,555
74,Chr3,3410890,3411012,3410951,122
74,Chr3,15666200,15666389,15666294,189
74,Chr3,19197748,19198205,19197976,457
74,Chr3,19848251,19850716,19849483,2465
74,Chr3,20849650,20850185,20849918,535
74,Chr4,75566,75713,75640,147
74,Chr5,74652,74758,74705,106
74,Chr5,21354505,21355244,21354875,739
74,Chr5,23085510,23085762,23085636,252
74,Chr5,23788122,23788440,23788281,318
74,Chr5,26350402,26350663,26350532,261
75,Chr1,468498,469548,469023,1050
75,Chr1,3094069,3094213,3094141,144
75,Chr1,5836942,5837376,5837159,434
75,Chr1,9043388,9043847,9043618,459
75,Chr1,22067304,22067917,22067610,613
75,Chr1,22745477,22745567,22745522,90
75,Chr1,26089930,26091799,26090864,1869
75,Chr1,28220921,28221593,28221257,672
75,Chr1,28932526,28934610,28933568,2084
75,Chr2,12305063,12308324,12306693,3261
75,Chr2,18358321,18359101,18358711,780
75,Chr3,9486878,9486962,9486920,84
75,Chr3,22985719,22992146,22988933,6427
75,Chr4,13206476,13206546,13206511,70
75,Chr5,4971880,4976064,4973972,4184
75,Chr5,6830772,6831253,6831012,481
75,Chr5,20856746,20856808,20856777,62
75,Chr5,23834609,23835884,23835247,1275
75,Chr5,25404109,25405030,25404569,921
76,Chr1,626197,627062,626629,865
76,Chr1,2104632,2105166,2104899,534
76,Chr1,2889822,2890823,2890322,1001
76,Chr1,3587880,3589889,3588884,2009
76,Chr1,11412409,11412673,11412541,264
76,Chr1,12009333,12014976,12012155,5643
76,Chr1,22332157,22333283,22332720,1126
76,Chr1,26056280,26056382,26056331,102
76,Chr2,7988442,7989608,7989025,1166
76,Chr2,10050609,10051350,10050979,741
76,Chr2,11296457,11297252,11296855,795
76,Chr2,11999327,12000031,11999679,704
76,Chr2,12851669,12852172,12851921,503
76,Chr2,14871774,14874386,14873080,2612
76,Chr2,18935013,18938194,18936603,3181
76,Chr2,19089195,19089423,19089309,228
76,Chr3,4336148,4336412,4336280,264
76,Chr3,4803103,4803194,4803149,91
76,Chr3,10438413,10439856,10439135,1443
76,Chr3,17751036,17752098,17751567,1062
76,Chr4,7371421,7371651,7371536,230
76,Chr4,11238074,11238413,11238244,339
76,Chr5,1896054,1900974,1898514,4920
76,Chr5,6103566,6104119,6103842,553
76,Chr5,16787423,16789434,16788429,2011
77,Chr1,3670938,3674112,3672525,3174
77,Chr1,9310815,9311065,9310940,250
77,Chr1,11571666,11573374,11572520,1708
77,Chr1,13963313,13964924,13964119,1611
77,Chr1,22779875,22779966,22779921,91
77,Chr1,26085291,26088853,26087072,3562
77,Chr2,8091174,8091333,8091254,159
77,Chr2,8779182,8779819,8779500,637
77,Chr2,9516312,9518183,9517248,1871
77,Chr3,1000641,1000786,1000713,145
77,Chr3,1465978,1466185,1466082,207
77,Chr3,4984888,4986284,4985586,1396
77,Chr3,7284148,7284848,7284498,700
77,Chr3,16124619,16124781,16124700,162
77,Chr3,21453235,21465064,21459149,11829
77,Chr4,18411881,18411985,18411933,104
77,Chr5,4936181,4937037,4936609,856
77,Chr5,5709101,5710751,5709926,1650
77,Chr5,6253683,6253704,6253693,21
77,Chr5,14874724,14875833,14875278,1109
77,Chr5,16520569,16521796,16521183,1227
77,Chr5,18512821,18513032,18512927,211
77,Chr5,22773905,22774562,22774233,657
78,Chr1,4966392,4967219,4966806,827
78,Chr1,4967219,4969845,4968532,2626
78,Chr1,8915918,8916717,8916318,799
78,Chr1,17307283,17307886,17307585,603
78,Chr1,28937757,28939559,28938658,1802
78,Chr2,6997526,6998787,6998156,1261
78,Chr2,10449411,10451478,10450445,2067
78,Chr2,13113744,13114897,13114320,1153
78,Chr2,16055911,16056233,16056072,322
78,Chr2,16497415,16497592,16497503,177
78,Chr2,16984006,16984918,16984462,912
78,Chr3,3430173,3430473,3430323,300
78,Chr3,5165100,5165948,5165524,848
78,Chr3,17995086,17995481,17995284,395
78,Chr3,20970834,20970923,20970878,89
78,Chr3,22276885,22279058,22277971,2173
78,Chr4,9772769,9773545,9773157,776
78,Chr5,47202,47796,47499,594
78,Chr5,358859,360093,359476,1234
78,Chr5,18148417,18148664,18148541,247
78,Chr5,19535846,19536152,19535999,306
79,Chr1,207856,210319,209088,2463
79,Chr1,3404569,3406508,3405539,1939
79,Chr1,4267957,4268316,4268137,359
79,Chr1,5798986,5799043,5799014,57
79,Chr1,7434764,7434865,7434814,101
79,Chr1,9308755,9309865,9309310,1110
79,Chr1,13052023,13054815,13053419,2792
79,Chr1,15985772,15986009,15985890,237
79,Chr1,18123795,18123869,18123832,74
79,Chr1,20605860,20606644,20606252,784
79,Chr1,28370761,28371780,28371271,1019
79,Chr1,28921564,28922256,28921910,692
79,Chr2,584278,584455,584366,177
79,Chr2,15158329,15162647,15160488,4318
79,Chr2,17997522,17998729,17998126,1207
79,Chr3,180519,181831,181175,1312
79,Chr3,6519252,6520545,6519898,1293
79,Chr3,15783740,15783790,15783765,50
79,Chr3,16344337,16344393,16344365,56
79,Chr3,19000667,19002787,19001727,2120
79,Chr4,12939029,12940145,12939587,1116
79,Chr5,942302,942588,942445,286
79,Chr5,6874461,6874505,6874483,44
79,Chr5,20471854,20471957,20471906,103
79,Chr5,23096407,23097067,23096737,660
79,Chr5,23670060,23670613,23670336,553
8,Chr1,1339414,1382716,1361065,43302
8,Chr1,9085990,9092461,9089226,6471
8,Chr1,11957773,11959322,11958547,1549
8,Chr1,26495630,26500854,26498242,5224
8,Chr1,28837455,28837620,28837537,165
8,Chr1,30175710,30176186,30175948,476
8,Chr2,14769359,14771775,14770567,2416
8,Chr2,19020676,19044487,19032582,23811
8,Chr3,5079747,5079992,5079869,245
8,Chr3,8117037,8117809,8117423,772
8,Chr3,9496147,9497141,9496644,994
8,Chr3,18080722,18081104,18080913,382
8,Chr3,19168032,19168104,19168068,72
8,Chr3,21113928,21115256,21114592,1328
8,Chr3,22353935,22360152,22357043,6217
8,Chr4,1027159,1029193,1028176,2034
8,Chr4,7760578,7761145,7760862,567
8,Chr4,12493471,12494405,12493938,934
8,Chr5,943029,943871,943450,842
8,Chr5,3412795,3415012,3413903,2217
8,Chr5,6061003,6061837,6061420,834
8,Chr5,16002995,16003148,16003071,153
8,Chr5,16671520,16671821,16671670,301
8,Chr5,22183492,22184802,22184147,1310
8,Chr5,25080278,25080860,25080569,582
8,Chr5,26265591,26265653,26265622,62
80,Chr1,971198,986719,978958,15521
80,Chr1,1572461,1572631,1572546,170
80,Chr1,12974080,12974439,12974260,359
80,Chr1,25800659,25801447,25801053,788
80,Chr1,28631772,28635121,28633446,3349
80,Chr3,19998516,19998767,19998642,251
80,Chr3,21028268,21029453,21028860,1185
80,Chr4,10855990,10856843,10856416,853
80,Chr5,521614,522414,522014,800
80,Chr5,3140278,3140505,3140392,227
80,Chr5,4281411,4282635,4282023,1224
80,Chr5,7671214,7671852,7671533,638
81,Chr1,1978171,1979865,1979018,1694
81,Chr1,19891064,19892491,19891778,1427
81,Chr1,25233309,25233655,25233482,346
81,Chr2,369164,378561,373862,9397
81,Chr2,7827918,7828703,7828310,785
81,Chr2,13031944,13032087,13032016,143
81,Chr2,15739846,15747720,15743783,7874
81,Chr2,18454547,18454806,18454677,259
81,Chr3,2092440,2092843,2092642,403
81,Chr4,6560297,6563047,6561672,2750
81,Chr4,12399009,12399122,12399065,113
81,Chr5,2253219,2253579,2253399,360
81,Chr5,5616713,5617255,5616984,542
81,Chr5,23095022,23095852,23095437,830
81,Chr5,26329236,26329940,26329588,704
82,Chr1,1348919,1382716,1365817,33797
82,Chr1,2307040,2308714,2307877,1674
82,Chr1,5784942,5786383,5785662,1441
82,Chr1,8378415,8378987,8378701,572
82,Chr1,9050494,9062110,9056302,11616
82,Chr1,12037278,12038080,12037679,802
82,Chr1,16736916,16737235,16737076,319
82,Chr1,21415153,21415213,21415183,60
82,Chr1,24536640,24536705,24536672,65
82,Chr2,9734084,9734341,9734212,257
82,Chr2,13633344,13636054,13634699,2710
82,Chr2,15135397,15136696,15136047,1299
82,Chr2,15975546,15975836,15975691,290
82,Chr2,17890747,17892211,17891479,1464
82,Chr3,21168445,21169425,21168935,980
82,Chr3,23229739,23242592,23236165,12853
82,Chr4,5367927,5368132,5368029,205
82,Chr4,11893282,11898058,11895670,4776
82,Chr4,12372943,12373945,12373444,1002
82,Chr4,13722184,13723073,13722628,889
82,Chr5,873225,873522,873373,297
82,Chr5,2715275,2716086,2715681,811
82,Chr5,5141350,5141393,5141372,43
82,Chr5,15390937,15391148,15391043,211
82,Chr5,19278457,19279465,19278961,1008
82,Chr5,24857532,24858928,24858230,1396
83,Chr1,165059,165930,165495,871
83,Chr1,4650732,4690603,4670668,39871
83,Chr1,24401009,24401197,24401103,188
83,Chr1,25599417,25600110,25599763,693
83,Chr1,27371411,27371546,27371479,135
83,Chr1,28639587,28651893,28645740,12306
83,Chr1,29177410,29178311,29177860,901
83,Chr2,636534,636826,636680,292
83,Chr2,6017200,6017393,6017296,193
83,Chr3,1056029,1056096,1056063,67
83,Chr3,1433139,1437500,1435319,4361
83,Chr3,3813434,3813760,3813597,326
83,Chr3,4045875,4051898,4048887,6023
83,Chr3,7477119,7477362,7477241,243
83,Chr3,18467460,18469493,18468476,2033
83,Chr3,19269609,19270241,19269925,632
83,Chr3,20508558,20509673,20509116,1115
83,Chr3,21252409,21255182,21253795,2773
83,Chr5,895470,895635,895552,165
83,Chr5,2628654,2630032,2629343,1378
83,Chr5,3987731,3988330,3988031,599
83,Chr5,5689302,5691287,5690294,1985
83,Chr5,16463978,16464742,16464360,764
83,Chr5,25612316,25613136,25612726,820
84,Chr1,1767875,1769477,1768676,1602
84,Chr1,2217657,2219191,2218424,1534
84,Chr1,5425385,5425485,5425435,100
84,Chr1,7087759,7088943,7088351,1184
84,Chr1,8571783,8571895,8571839,112
84,Chr1,9800561,9801258,9800909,697
84,Chr1,10680313,10680501,10680407,188
84,Chr1,29763058,29763145,29763102,87
84,Chr1,30216176,30219609,30217892,3433
84,Chr2,221764,222306,222035,542
84,Chr2,9100621,9103172,9101897,2551
84,Chr2,14199880,14200926,14200403,1046
84,Chr2,15274831,15276064,15275447,1233
84,Chr2,16694743,16695529,16695136,786
84,Chr3,2141646,2143000,2142323,1354
84,Chr3,17507109,17507138,17507123,29
84,Chr3,17990167,17991215,17990691,1048
84,Chr4,6467056,6467136,6467096,80
84,Chr4,8573626,8574142,8573884,516
84,Chr4,10461286,10461288,10461287,2
84,Chr4,16405712,16405769,16405740,57
84,Chr4,16833388,16833793,16833590,405
84,Chr5,3256475,3256962,3256719,487
84,Chr5,16661778,16663275,16662526,1497
84,Chr5,19294041,19294464,19294253,423
84,Chr5,19766731,19768794,19767763,2063
84,Chr5,23351262,23351410,23351336,148
84,Chr5,25356567,25357125,25356846,558
85,Chr1,2435777,2436334,2436055,557
85,Chr1,6022477,6022482,6022479,5
85,Chr1,18362466,18363120,18362793,654
85,Chr1,26768271,26768814,26768543,543
85,Chr1,27301217,27301545,27301381,328
85,Chr2,13703545,13704291,13703918,746
85,Chr3,1360291,1362437,1361364,2146
85,Chr3,17591745,17591878,17591811,133
85,Chr4,653888,653976,653932,88
85,Chr4,13781526,13793924,13787725,12398
85,Chr4,14148398,14148814,14148606,416
85,Chr5,301145,301689,301417,544
85,Chr5,5786377,5786427,5786402,50
85,Chr5,6771329,6772888,6772109,1559
85,Chr5,14989825,14990154,14989989,329
85,Chr5,16114543,16116253,16115398,1710
85,Chr5,19597998,19598134,19598066,136
86,Chr1,773423,774594,774009,1171
86,Chr1,2341114,2342083,2341598,969
86,Chr1,2848821,2849453,2849137,632
86,Chr1,3268864,3269670,3269267,806
86,Chr1,4991438,4993000,4992219,1562
86,Chr1,7445310,7446994,7446152,1684
86,Chr1,9363070,9364128,9363599,1058
86,Chr1,12003943,12004173,12004058,230
86,Chr1,17283616,17284161,17283888,545
86,Chr1,20606644,20615934,20611289,9290
86,Chr1,22308373,22308636,22308505,263
86,Chr1,26301685,26302051,26301868,366
86,Chr2,2177366,2181177,2179272,3811
86,Chr2,7428009,7428307,7428158,298
86,Chr2,8227947,8228696,8228321,749
86,Chr2,9381859,9382095,9381977,236
86,Chr2,18126188,18126946,18126567,758
86,Chr2,19369713,19374848,19372281,5135
86,Chr3,39624,40165,39894,541
86,Chr3,757688,757885,757786,197
86,Chr3,2747110,2747833,2747472,723
86,Chr3,19105656,19108287,19106972,2631
86,Chr3,20229424,20230316,20229870,892
86,Chr4,1396166,1397708,1396937,1542
86,Chr4,5804885,5805160,5805023,275
86,Chr4,7876517,7876577,7876547,60
86,Chr4,10372050,10373432,10372741,1382
86,Chr4,13137556,13137784,13137670,228
86,Chr4,13781526,13793924,13787725,12398
86,Chr5,285588,286921,286254,1333
86,Chr5,2584177,2584404,2584291,227
86,Chr5,3871424,3881347,3876386,9923
86,Chr5,4373886,4374237,4374062,351
86,Chr5,7512385,7522916,7517651,10531
86,Chr5,15946821,15947270,15947045,449
86,Chr5,20230616,20230943,20230780,327
86,Chr5,22360454,22360807,22360630,353
86,Chr5,23225153,23225545,23225349,392
86,Chr5,24375173,24375644,24375409,471
86,Chr5,25014054,25015526,25014790,1472
86,Chr5,26468433,26469533,26468983,1100
87,Chr1,1438193,1438278,1438235,85
87,Chr1,6907590,6909432,6908511,1842
87,Chr1,10614939,10615079,10615009,140
87,Chr1,17914148,17914661,17914404,513
87,Chr1,21465733,21465826,21465779,93
87,Chr1,28651893,28724228,28688061,72335
87,Chr1,29271451,29271610,29271531,159
87,Chr2,1936443,1936513,1936478,70
87,Chr2,15392508,15392649,15392578,141
87,Chr2,16292802,16294758,16293780,1956
87,Chr2,18538078,18539861,18538970,1783
87,Chr3,528246,531454,529850,3208
87,Chr3,1340955,1341200,1341077,245
87,Chr3,1753200,1753832,1753516,632
87,Chr3,2774252,2774950,2774601,698
87,Chr3,22102966,22103311,22103138,345
87,Chr3,23382031,23383677,23382854,1646
87,Chr4,9971124,9972991,9972058,1867
87,Chr4,12573224,12574798,12574011,1574
87,Chr4,13107774,13108350,13108062,576
87,Chr4,14360933,14361934,14361433,1001
87,Chr5,3481663,3481778,3481721,115
87,Chr5,7675446,7675502,7675474,56
87,Chr5,17858288,17859216,17858752,928
87,Chr5,21137758,21138496,21138127,738
87,Chr5,24090023,24092262,24091143,2239
88,Chr1,432547,445271,438909,12724
88,Chr1,850465,858097,854281,7632
88,Chr1,5776349,5782267,5779308,5918
88,Chr1,6782450,6783673,6783062,1223
88,Chr1,20564888,20564957,20564922,69
88,Chr1,21090752,21092415,21091584,1663
88,Chr1,23461757,23462084,23461921,327
88,Chr1,24120488,24122588,24121538,2100
88,Chr1,26300347,26301393,26300870,1046
88,Chr1,28823928,28826609,28825268,2681
88,Chr2,7377662,7377942,7377802,280
88,Chr3,2354033,2354193,2354113,160
88,Chr3,2797719,2798039,2797879,320
88,Chr3,17535928,17536221,17536074,293
88,Chr3,20001581,20002920,20002251,1339
88,Chr3,21251600,21251948,21251774,348
88,Chr5,679099,680101,679600,1002
88,Chr5,2272182,2272767,2272474,585
88,Chr5,5566367,5572045,5569206,5678
88,Chr5,6053438,6053966,6053702,528
88,Chr5,6605717,6606218,6605967,501
88,Chr5,7417572,7420714,7419143,3142
88,Chr5,14864283,14864740,14864511,457
88,Chr5,22718594,22724170,22721382,5576
88,Chr5,24387584,24387895,24387740,311
89,Chr1,2646710,2647801,2647256,1091
89,Chr1,3354275,3361324,3357799,7049
89,Chr1,3850902,3851083,3850992,181
89,Chr1,5570668,5572098,5571383,1430
89,Chr1,10464440,10464937,10464688,497
89,Chr1,20572867,20588582,20580725,15715
89,Chr1,28651893,28724228,28688061,72335
89,Chr2,357844,357934,357889,90
89,Chr2,835752,836067,835910,315
89,Chr2,6927055,6927364,6927209,309
89,Chr2,19048717,19050712,19049715,1995
89,Chr3,884682,884989,884836,307
89,Chr3,2848524,2849342,2848933,818
89,Chr3,10216601,10216886,10216743,285
89,Chr3,21715632,21715788,21715710,156
89,Chr3,22272106,22274835,22273470,2729
89,Chr3,23361275,23361793,23361534,518
89,Chr3,23378863,23379760,23379311,897
89,Chr4,8374510,8374711,8374610,201
89,Chr4,10853467,10853772,10853619,305
89,Chr4,15859785,15859906,15859845,121
89,Chr4,17309247,17313542,17311395,4295
89,Chr5,2619771,2620393,2620082,622
89,Chr5,4929002,4936181,4932592,7179
89,Chr5,13242996,13243236,13243116,240
89,Chr5,20098291,20098373,20098332,82
89,Chr5,26030191,26030703,26030447,512
89,Chr5,26771746,26771865,26771806,119
9,Chr1,2303244,2303643,2303444,399
9,Chr1,16887653,16887677,16887665,24
9,Chr1,17643307,17644666,17643987,1359
9,Chr2,6866977,6867388,6867183,411
9,Chr2,13411384,13412268,13411826,884
9,Chr2,16563337,16564796,16564067,1459
9,Chr2,16857867,16858519,16858193,652
9,Chr2,19475253,19475316,19475285,63
9,Chr3,236566,236778,236672,212
9,Chr4,5403718,5403919,5403818,201
9,Chr4,8298704,8301826,8300265,3122
9,Chr4,14556393,14556501,14556447,108
9,Chr4,18031015,18031171,18031093,156
9,Chr4,18439490,18440151,18439820,661
9,Chr5,2938561,2940277,2939419,1716
9,Chr5,8013700,8013780,8013740,80
9,Chr5,15219793,15221461,15220627,1668
9,Chr5,21884520,21884773,21884646,253
9,Chr5,23767760,23768199,23767980,439
9,Chr5,24674596,24675313,24674954,717
9,Chr5,26595721,26596074,26595897,353
90,Chr1,210319,266254,238287,55935
90,Chr1,1221161,1221314,1221237,153
90,Chr1,10550212,10550298,10550255,86
90,Chr1,19289728,19290099,19289914,371
90,Chr2,13137294,13141824,13139559,4530
90,Chr2,15975546,15975836,15975691,290
90,Chr2,17106850,17106908,17106879,58
90,Chr2,18469364,18469887,18469626,523
90,Chr2,18996356,18998157,18997256,1801
90,Chr3,3309651,3309945,3309798,294
90,Chr3,5079992,5124565,5102278,44573
90,Chr3,16111011,16111390,16111201,379
90,Chr3,18750187,18750384,18750285,197
90,Chr4,576276,576758,576517,482
90,Chr4,9411352,9411544,9411448,192
90,Chr4,11716053,11716066,11716059,13
90,Chr4,13820553,13823571,13822062,3018
90,Chr4,18457137,18457201,18457169,64
90,Chr5,1773700,1773844,1773772,144
90,Chr5,2392028,2392306,2392167,278
90,Chr5,4452776,4454241,4453508,1465
90,Chr5,5130626,5130837,5130732,211
90,Chr5,24408436,24410594,24409515,2158
91,Chr1,120328,121077,120702,749
91,Chr1,28511506,28512067,28511786,561
91,Chr1,30305335,30307286,30306311,1951
91,Chr2,11137111,11139576,11138343,2465
91,Chr2,17878075,17878346,17878211,271
91,Chr2,19489551,19489799,19489675,248
91,Chr3,6013400,6013530,6013465,130
91,Chr3,6668479,6668977,6668728,498
91,Chr3,7928378,7928791,7928584,413
91,Chr3,19312262,19323523,19317892,11261
91,Chr3,19652339,19652778,19652559,439
91,Chr3,21677904,21681549,21679726,3645
91,Chr4,11172060,11172896,11172478,836
91,Chr4,12654965,12655457,12655211,492
91,Chr4,13793924,13816294,13805109,22370
91,Chr5,8639038,8639228,8639133,190
91,Chr5,14811242,14811537,14811390,295
91,Chr5,21750081,21751169,21750625,1088
91,Chr5,22738563,22739695,22739129,1132
92,Chr1,266254,266733,266494,479
92,Chr1,2139174,2139615,2139394,441
92,Chr1,4578300,4578315,4578308,15
92,Chr1,6811465,6811979,6811722,514
92,Chr1,19154775,19161501,19158138,6726
92,Chr1,20510777,20511632,20511205,855
92,Chr1,26742353,26745250,26743801,2897
92,Chr1,27410156,27414997,27412576,4841
92,Chr1,30331063,30331756,30331409,693
92,Chr2,13844121,13844466,13844293,345
92,Chr2,15541420,15541801,15541610,381
92,Chr3,1064461,1064628,1064545,167
92,Chr3,19114606,19116522,19115564,1916
92,Chr4,7340317,7340500,7340409,183
92,Chr4,8087637,8087942,8087789,305
92,Chr4,12526735,12527064,12526899,329
92,Chr4,13722184,13723073,13722628,889
92,Chr4,14403379,14404809,14404094,1430
92,Chr5,41563,44705,43134,3142
92,Chr5,1218261,1220178,1219219,1917
92,Chr5,3240922,3243073,3241998,2151
92,Chr5,6791042,6791364,6791203,322
92,Chr5,7420714,7422658,7421686,1944
92,Chr5,17100501,17100654,17100577,153
92,Chr5,22768044,22768051,22768048,7
92,Chr5,23281628,23282073,23281850,445
93,Chr1,1104250,1105328,1104789,1078
93,Chr1,3443042,3443081,3443062,39
93,Chr1,5070376,5072878,5071627,2502
93,Chr1,10448456,10448560,10448508,104
93,Chr1,23287832,23288396,23288114,564
93,Chr1,28898795,28899030,28898913,235
93,Chr1,29813994,29814005,29814000,11
93,Chr2,15122523,15124965,15123744,2442
93,Chr2,16638274,16639914,16639094,1640
93,Chr3,3313287,3313590,3313439,303
93,Chr3,7085041,7085305,7085173,264
93,Chr3,7972645,7974595,7973620,1950
93,Chr3,9460865,9462244,9461555,1379
93,Chr3,15744168,15783016,15763592,38848
93,Chr3,16499299,16499562,16499431,263
93,Chr3,18142884,18145329,18144106,2445
93,Chr4,171702,173028,172365,1326
93,Chr4,7306252,7306704,7306478,452
93,Chr4,10214012,10215700,10214856,1688
93,Chr4,10701616,10702179,10701898,563
93,Chr5,239679,240104,239891,425
93,Chr5,3846022,3846459,3846240,437
93,Chr5,7092263,7095841,7094052,3578
93,Chr5,8290560,8290949,8290754,389
93,Chr5,26056588,26058069,26057328,1481
94,Chr1,18914464,18915314,18914889,850
94,Chr1,20184501,20184541,20184521,40
94,Chr1,24706238,24706298,24706268,60
94,Chr1,26341261,26341373,26341317,112
94,Chr1,27577519,27579465,27578492,1946
94,Chr2,12793913,12795205,12794559,1292
94,Chr2,13862973,13865317,13864145,2344
94,Chr2,14707533,14708071,14707802,538
94,Chr2,15215901,15216086,15215993,185
94,Chr2,17141388,17142683,17142036,1295
94,Chr2,17925170,17927744,17926457,2574
94,Chr3,2392446,2394408,2393427,1962
94,Chr3,3442537,3443918,3443227,1381
94,Chr3,6914909,6929981,6922445,15072
94,Chr3,8657776,8658238,8658007,462
94,Chr4,5723568,5724682,5724125,1114
94,Chr4,9325896,9325978,9325937,82
94,Chr5,17105053,17107783,17106418,2730
94,Chr5,17650524,17650598,17650561,74
94,Chr5,23098340,23100287,23099314,1947
94,Chr5,24133625,24133708,24133667,83
94,Chr5,26574121,26574641,26574381,520
95,Chr1,1997543,1998107,1997825,564
95,Chr1,3446761,3448507,3447634,1746
95,Chr1,4784589,4788169,4786379,3580
95,Chr1,5415659,5416793,5416226,1134
95,Chr1,6673244,6673901,6673572,657
95,Chr1,9314985,9315281,9315133,296
95,Chr1,9429637,9429909,9429773,272
95,Chr1,11671670,11672024,11671847,354
95,Chr1,12853632,12862175,12857904,8543
95,Chr1,22273253,22273322,22273287,69
95,Chr1,25044866,25045059,25044962,193
95,Chr1,25671190,25672500,25671845,1310
95,Chr2,1093876,1095368,1094622,1492
95,Chr2,15497955,15498237,15498096,282
95,Chr2,16654836,16654932,16654884,96
95,Chr2,18303122,18303316,18303219,194
95,Chr2,19540470,19540635,19540552,165
95,Chr3,3751938,3754219,3753078,2281
95,Chr3,8751676,8752126,8751901,450
95,Chr3,18999418,18999922,18999670,504
95,Chr3,19492098,19492682,19492390,584
95,Chr3,20908291,20908734,20908513,443
95,Chr4,1182519,1183785,1183152,1266
95,Chr4,12298894,12299217,12299056,323
95,Chr4,18492629,18494079,18493354,1450
95,Chr5,842342,842553,842448,211
95,Chr5,2062433,2063132,2062783,699
95,Chr5,2630662,2630815,2630738,153
95,Chr5,6134373,6136159,6135266,1786
95,Chr5,18367549,18367700,18367625,151
96,Chr1,2874876,2875385,2875130,509
96,Chr1,4045873,4048532,4047203,2659
96,Chr1,7320585,7320905,7320745,320
96,Chr2,106095,106391,106243,296
96,Chr2,14127984,14128425,14128204,441
96,Chr2,19537457,19538347,19537902,890
96,Chr3,633912,634938,634425,1026
96,Chr3,1071176,1072013,1071594,837
96,Chr3,2052373,2053073,2052723,700
96,Chr3,6567732,6575993,6571862,8261
96,Chr3,8783367,8783734,8783551,367
96,Chr3,9223774,9223933,9223854,159
96,Chr3,15950619,15951225,15950922,606
96,Chr3,23086544,23086890,23086717,346
96,Chr3,23352500,23353305,23352902,805
96,Chr4,756710,756806,756758,96
96,Chr4,11557681,11558912,11558297,1231
96,Chr4,12909368,12909983,12909676,615
96,Chr5,2411777,2412029,2411903,252
96,Chr5,2590602,2590871,2590736,269
96,Chr5,3465934,3466030,3465982,96
96,Chr5,5051512,5054710,5053111,3198
96,Chr5,6572595,6573635,6573115,1040
96,Chr5,8274309,8274632,8274471,323
96,Chr5,9044787,9045619,9045203,832
96,Chr5,16369725,16370007,16369866,282
96,Chr5,20720207,20720455,20720331,248
97,Chr1,7427611,7429539,7428575,1928
97,Chr1,10649620,10650339,10649980,719
97,Chr1,27162370,27162703,27162536,333
97,Chr2,2323853,2323898,2323875,45
97,Chr2,9010722,9010779,9010750,57
97,Chr2,12625806,12625995,12625900,189
97,Chr2,17519563,17520080,17519821,517
97,Chr2,19374848,19383373,19379110,8525
97,Chr3,679071,679861,679466,790
97,Chr3,3290911,3308301,3299606,17390
97,Chr3,5684419,5685201,5684810,782
97,Chr3,6063088,6064555,6063822,1467
97,Chr3,10085651,10086208,10085929,557
97,Chr3,17960952,17961117,17961034,165
97,Chr3,19201045,19201582,19201313,537
97,Chr4,486029,486098,486063,69
97,Chr4,5748290,5748315,5748302,25
97,Chr4,13333128,13333220,13333174,92
97,Chr4,18177274,18177366,18177320,92
97,Chr5,173966,174278,174122,312
97,Chr5,2861682,2874908,2868295,13226
97,Chr5,8752870,8752999,8752934,129
97,Chr5,19838285,19839941,19839113,1656
97,Chr5,21471031,21471394,21471213,363
98,Chr1,180816,181261,181038,445
98,Chr1,922673,926723,924698,4050
98,Chr1,2083668,2084255,2083962,587
98,Chr1,4946045,4948849,4947447,2804
98,Chr1,8977128,8985127,8981128,7999
98,Chr1,17712725,17712810,17712767,85
98,Chr1,19213737,19214100,19213919,363
98,Chr1,21037466,21037587,21037526,121
98,Chr1,29703237,29703723,29703480,486
98,Chr1,30159817,30160123,30159970,306
98,Chr2,11015459,11016635,11016047,1176
98,Chr2,13373968,13374533,13374250,565
98,Chr2,15064481,15065699,15065090,1218
98,Chr2,17516501,17517658,17517079,1157
98,Chr3,386105,386901,386503,796
98,Chr3,4346182,4347084,4346633,902
98,Chr3,7282681,7284148,7283415,1467
98,Chr3,8111500,8112461,8111980,961
98,Chr3,17523784,17525706,17524745,1922
98,Chr3,18810910,18811037,18810974,127
98,Chr3,20551489,20551654,20551571,165
98,Chr4,6703419,6704184,6703801,765
98,Chr4,7130098,7130248,7130173,150
98,Chr5,2616325,2616672,2616499,347
98,Chr5,3401440,3402076,3401758,636
98,Chr5,4151896,4152021,4151958,125
98,Chr5,7271121,7271557,7271339,436
98,Chr5,13462088,13462497,13462292,409
98,Chr5,16201155,16201333,16201244,178
98,Chr5,20764196,20765491,20764844,1295
98,Chr5,24420920,24421706,24421313,786
98,Chr5,26760537,26760897,26760717,360
99,Chr1,3890315,3891139,3890727,824
99,Chr1,5287018,5287462,5287240,444
99,Chr1,29274583,29275484,29275033,901
99,Chr2,7361630,7361844,7361737,214
99,Chr2,7711877,7712339,7712108,462
99,Chr2,15014143,15014426,15014285,283
99,Chr2,15390018,15392508,15391263,2490
99,Chr2,18228405,18259080,18243743,30675
99,Chr3,11530032,11530147,11530090,115
99,Chr4,8253467,8253648,8253557,181
99,Chr4,9597238,9600185,9598712,2947
99,Chr4,10270645,10271931,10271288,1286
99,Chr4,13723230,13764990,13744110,41760
99,Chr5,15631158,15632113,15631636,955
99,Chr5,18972982,18973207,18973094,225
99,Chr5,26491269,26492086,26491677,817
