lib,chrs,start,stop,cos,width
1,Chr1,6625206,6625801,6625504,595
1,Chr3,1055555,1055777,1055666,222
1,Chr3,11010533,11011282,11010907,749
1,Chr3,15569055,15569264,15569159,209
1,Chr4,1508037,1508284,1508161,247
1,Chr5,14104483,14105415,14104949,932
1,Chr5,21504598,21504921,21504760,323
10,Chr1,19849851,19849855,19849853,4
10,Chr2,9987868,9987872,9987870,4
10,Chr2,12293246,12294066,12293656,820
10,Chr4,5183574,5184244,5183909,670
10,Chr5,9969044,9969375,9969210,331
10,Chr5,22277559,22278703,22278131,1144
11,Chr1,1696028,1696198,1696113,170
11,Chr3,17254846,17258036,17256441,3190
11,Chr4,5365189,5365304,5365247,115
11,Chr5,8030776,8030928,8030852,152
11,Chr5,13230948,13231039,13230994,91
11,Chr5,18065052,18065172,18065112,120
11,Chr5,23081094,23081897,23081496,803
12,Chr1,11196183,11196559,11196371,376
12,Chr1,24581908,24582693,24582300,785
12,Chr3,1121465,1122294,1121879,829
12,Chr3,14811793,14812859,14812326,1066
12,Chr3,15703814,15705362,15704588,1548
12,Chr4,17239446,17240357,17239902,911
12,Chr5,8419098,8419338,8419218,240
12,Chr5,21191754,21192372,21192063,618
13,Chr1,8354852,8355045,8354948,193
13,Chr1,16643504,16643665,16643584,161
13,Chr1,23577940,23578489,23578214,549
13,Chr1,29878497,29879361,29878929,864
13,Chr2,6916607,6916706,6916657,99
13,Chr3,23176452,23176940,23176696,488
13,Chr4,16693938,16694586,16694262,648
13,Chr5,7811026,7812011,7811518,985
13,Chr5,21292983,21293186,21293085,203
14,Chr2,7052937,7053014,7052975,77
14,Chr2,17993164,17995439,17994302,2275
14,Chr2,19246564,19247800,19247182,1236
14,Chr3,809961,810135,810048,174
14,Chr3,15991816,15994063,15992940,2247
14,Chr4,6964554,6964681,6964618,127
15,Chr1,3561504,3562114,3561809,610
15,Chr1,4872272,4872961,4872616,689
15,Chr1,8946816,8947867,8947342,1051
15,Chr1,20445369,20446829,20446099,1460
15,Chr1,25258718,25260660,25259689,1942
15,Chr3,10738349,10738388,10738369,39
15,Chr3,18676303,18676322,18676313,19
15,Chr4,1048582,1048971,1048776,389
15,Chr4,17413867,17414726,17414297,859
15,Chr5,7752283,7752439,7752361,156
15,Chr5,14717937,14718224,14718081,287
15,Chr5,22191807,22192081,22191944,274
15,Chr5,25197899,25199080,25198489,1181
16,Chr1,4889209,4890219,4889714,1010
16,Chr1,12183347,12184393,12183870,1046
16,Chr1,29468158,29468474,29468316,316
16,Chr2,19014885,19014963,19014924,78
16,Chr3,15665059,15666043,15665551,984
16,Chr3,20379241,20380359,20379800,1118
16,Chr4,5143324,5143455,5143390,131
16,Chr5,25921384,25922647,25922016,1263
17,Chr1,6315038,6315442,6315240,404
17,Chr1,20785180,20785619,20785400,439
17,Chr2,12353512,12354308,12353910,796
17,Chr4,1397847,1397954,1397901,107
17,Chr4,12102390,12102917,12102654,527
17,Chr4,18209239,18210972,18210105,1733
17,Chr5,9868076,9869689,9868882,1613
18,Chr1,8448407,8448613,8448510,206
18,Chr1,16813509,16813871,16813690,362
18,Chr1,24538854,24541819,24540336,2965
18,Chr2,6542501,6542833,6542667,332
18,Chr3,15502186,15502255,15502220,69
18,Chr4,14769226,14773912,14771569,4686
18,Chr5,3141165,3141794,3141479,629
18,Chr5,16163277,16163721,16163499,444
19,Chr1,8655687,8655715,8655701,28
19,Chr1,23138212,23138507,23138360,295
19,Chr2,584278,584455,584366,177
19,Chr2,11650786,11650852,11650819,66
19,Chr3,18835469,18835787,18835628,318
19,Chr5,10238732,10239128,10238930,396
19,Chr5,21138846,21139502,21139174,656
2,Chr1,16430200,16430791,16430496,591
2,Chr2,970449,970554,970501,105
2,Chr2,6669063,6669805,6669434,742
2,Chr2,11565998,11566529,11566264,531
2,Chr3,513431,513600,513515,169
2,Chr3,10355181,10355324,10355253,143
2,Chr3,22369129,22371553,22370341,2424
2,Chr4,1197316,1197362,1197339,46
2,Chr5,13880957,13882391,13881674,1434
20,Chr1,432021,432547,432284,526
20,Chr1,17252565,17252626,17252595,61
20,Chr1,20236721,20236779,20236750,58
20,Chr1,29163082,29163173,29163128,91
20,Chr2,12430587,12430748,12430667,161
20,Chr3,17479224,17479256,17479240,32
20,Chr4,6752117,6752193,6752155,76
21,Chr1,562860,563367,563114,507
21,Chr2,1867137,1867994,1867565,857
21,Chr2,7995138,7995274,7995206,136
21,Chr2,10800209,10800429,10800319,220
21,Chr3,3614332,3614825,3614578,493
21,Chr3,9423138,9425914,9424526,2776
21,Chr3,21656386,21677904,21667145,21518
21,Chr4,5700959,5701150,5701055,191
21,Chr4,7369829,7370740,7370285,911
21,Chr5,494318,497380,495849,3062
21,Chr5,6414528,6414575,6414552,47
21,Chr5,9076686,9077649,9077168,963
21,Chr5,26729049,26729813,26729431,764
22,Chr1,1147537,1148269,1147903,732
22,Chr2,7365632,7365944,7365788,312
22,Chr3,17997323,17997566,17997445,243
22,Chr5,26817862,26818104,26817983,242
23,Chr1,8699720,8699795,8699758,75
23,Chr2,1693043,1696398,1694721,3355
23,Chr2,7106499,7107182,7106841,683
23,Chr3,909390,910246,909818,856
23,Chr3,8858623,8858872,8858747,249
23,Chr3,19948548,19948807,19948678,259
23,Chr4,7807771,7808014,7807893,243
23,Chr4,18183975,18185822,18184899,1847
23,Chr5,20721947,20722285,20722116,338
24,Chr1,23513942,23514372,23514157,430
24,Chr3,16940390,16940793,16940592,403
24,Chr4,1306905,1308587,1307746,1682
24,Chr4,5986030,5986330,5986180,300
24,Chr4,10849304,10849382,10849343,78
24,Chr5,6981844,6982037,6981940,193
25,Chr1,17768126,17768443,17768284,317
25,Chr1,27979725,27980152,27979939,427
25,Chr2,19354836,19354940,19354888,104
25,Chr3,12597801,12598950,12598375,1149
25,Chr4,177047,177244,177145,197
25,Chr4,739223,739367,739295,144
25,Chr4,14277732,14277738,14277735,6
25,Chr5,8557401,8559368,8558385,1967
26,Chr1,11061304,11062278,11061791,974
26,Chr2,2024893,2071438,2048165,46545
26,Chr2,15515610,15515736,15515673,126
26,Chr3,2076039,2076180,2076109,141
26,Chr3,10742051,10742318,10742185,267
26,Chr4,5301387,5301856,5301621,469
26,Chr4,9991654,9993665,9992660,2011
26,Chr5,8676685,8677442,8677063,757
27,Chr1,13999200,15983742,14991471,1984542
27,Chr1,23495517,23496852,23496185,1335
27,Chr3,3948135,3948751,3948443,616
27,Chr3,23261142,23261229,23261186,87
27,Chr5,2449765,2451940,2450853,2175
27,Chr5,21244874,21250196,21247535,5322
28,Chr1,6621623,6622215,6621919,592
28,Chr1,8937260,8938844,8938052,1584
28,Chr4,5300356,5300575,5300466,219
28,Chr4,11256462,11256548,11256505,86
29,Chr1,9897382,9898891,9898136,1509
29,Chr1,19694584,19695428,19695006,844
29,Chr2,19556968,19557034,19557001,66
29,Chr5,21120766,21120893,21120830,127
3,Chr2,7231417,7231446,7231431,29
3,Chr2,17748864,17755511,17752188,6647
3,Chr3,9836293,9836333,9836313,40
3,Chr4,18206405,18208163,18207284,1758
3,Chr5,8146241,8146842,8146541,601
3,Chr5,25975808,25976643,25976226,835
30,Chr1,13683572,13689385,13686478,5813
30,Chr1,27095306,27095813,27095560,507
30,Chr2,6686955,6686957,6686956,2
30,Chr2,11797597,11797697,11797647,100
30,Chr3,9836333,9837698,9837015,1365
30,Chr3,10361673,10362105,10361889,432
30,Chr5,13593377,13593668,13593523,291
30,Chr5,25739216,25739673,25739444,457
31,Chr1,4233888,4235774,4234831,1886
31,Chr1,21933505,21935211,21934358,1706
31,Chr1,29368595,29368894,29368745,299
31,Chr2,448940,448998,448969,58
31,Chr2,9977107,9977156,9977131,49
31,Chr3,8064661,8065655,8065158,994
31,Chr4,10751900,10752203,10752052,303
31,Chr5,22954982,22955807,22955394,825
32,Chr1,8405137,8431089,8418113,25952
32,Chr1,16471958,16472503,16472230,545
32,Chr1,23189519,23189900,23189709,381
32,Chr2,362656,365116,363886,2460
32,Chr2,12783726,12784025,12783876,299
32,Chr3,1755396,1755580,1755488,184
32,Chr3,7213724,7214290,7214007,566
32,Chr4,12087886,12088745,12088316,859
32,Chr5,8379288,8379646,8379467,358
33,Chr1,1461286,1461848,1461567,562
33,Chr1,8901085,8909492,8905289,8407
33,Chr2,811008,812905,811956,1897
33,Chr2,9859106,9861187,9860146,2081
33,Chr3,8922751,8923137,8922944,386
33,Chr3,11811085,11811148,11811117,63
33,Chr3,22187889,22188747,22188318,858
33,Chr4,130310,130947,130628,637
33,Chr4,17442797,17442975,17442886,178
33,Chr5,939862,940266,940064,404
33,Chr5,8874155,8876444,8875299,2289
33,Chr5,20941287,20941544,20941415,257
34,Chr1,4233446,4233888,4233667,442
34,Chr2,393806,397399,395602,3593
34,Chr3,5566821,5567037,5566929,216
34,Chr3,9377671,9377864,9377767,193
34,Chr3,10767910,10772633,10770272,4723
34,Chr4,9320279,9320382,9320331,103
34,Chr5,155033,155384,155209,351
34,Chr5,8581361,8581461,8581411,100
35,Chr1,16707916,16708925,16708420,1009
35,Chr1,20021336,20021721,20021528,385
35,Chr2,6778351,6778527,6778439,176
35,Chr2,12292753,12293246,12292999,493
35,Chr3,8876464,8878314,8877389,1850
35,Chr3,10047717,10048158,10047937,441
35,Chr5,15471232,15471301,15471266,69
36,Chr1,2613673,2613733,2613703,60
36,Chr1,8180027,8181523,8180775,1496
36,Chr1,24871132,24877256,24874194,6124
36,Chr2,9523800,9525938,9524869,2138
36,Chr2,17251808,17320860,17286334,69052
36,Chr3,17556913,17558484,17557699,1571
36,Chr4,1037274,1037435,1037354,161
36,Chr4,5371250,5371418,5371334,168
36,Chr5,13880021,13880178,13880099,157
37,Chr1,10416126,10416694,10416410,568
37,Chr2,6544373,6544638,6544505,265
37,Chr3,11395583,11395728,11395655,145
37,Chr4,11734781,11735507,11735144,726
38,Chr1,11474185,11475408,11474797,1223
38,Chr1,11610967,11611886,11611427,919
38,Chr2,6090218,6090272,6090245,54
38,Chr3,1440156,1440308,1440232,152
38,Chr3,19858407,19859025,19858716,618
38,Chr4,11860372,11862501,11861436,2129
38,Chr4,17802729,17802898,17802813,169
39,Chr1,4296378,4297086,4296732,708
39,Chr1,7172709,7174610,7173659,1901
39,Chr1,8941255,8941403,8941329,148
39,Chr2,407539,407596,407567,57
39,Chr2,674936,675069,675002,133
39,Chr3,3046687,3047632,3047159,945
39,Chr3,15673993,15674759,15674376,766
39,Chr5,17654288,17654434,17654361,146
4,Chr1,7118491,7120370,7119431,1879
4,Chr1,18364561,18365892,18365227,1331
4,Chr2,8093964,8094161,8094062,197
4,Chr3,6249723,6249982,6249853,259
4,Chr4,7784029,7785146,7784587,1117
4,Chr5,4647184,4647800,4647492,616
4,Chr5,17606521,17607351,17606936,830
40,Chr1,1636129,1638242,1637185,2113
40,Chr1,22782428,22783568,22782998,1140
40,Chr2,1123201,1124107,1123654,906
40,Chr2,6035326,6035766,6035546,440
40,Chr2,12338968,12339408,12339188,440
40,Chr3,16107981,16108235,16108108,254
40,Chr4,17361281,17361409,17361345,128
40,Chr5,2630662,2630815,2630738,153
40,Chr5,26505939,26506415,26506177,476
41,Chr1,17061140,17061559,17061350,419
41,Chr1,28915921,28916365,28916143,444
41,Chr2,6761233,6761284,6761259,51
41,Chr3,497885,500016,498951,2131
41,Chr3,6439892,6440988,6440440,1096
41,Chr4,5233063,5234821,5233942,1758
41,Chr4,11753969,11754429,11754199,460
41,Chr5,8912309,8912768,8912539,459
41,Chr5,14540899,14541393,14541146,494
41,Chr5,26625640,26626889,26626264,1249
42,Chr1,21442804,21443701,21443252,897
42,Chr1,26729509,26729555,26729532,46
42,Chr4,8908056,8908558,8908307,502
43,Chr1,11223660,11223888,11223774,228
43,Chr2,10350602,10350726,10350664,124
43,Chr3,8712101,8712338,8712219,237
44,Chr1,12974080,12974439,12974260,359
44,Chr1,24787980,24788480,24788230,500
44,Chr2,9511031,9511103,9511067,72
44,Chr3,8688052,8689343,8688698,1291
44,Chr5,26291554,26292136,26291845,582
44,Chr5,26807852,26807984,26807918,132
45,Chr1,7638527,7639278,7638903,751
45,Chr1,30222052,30222103,30222078,51
45,Chr2,9908718,9908885,9908802,167
45,Chr3,469136,469557,469346,421
45,Chr3,16741780,16741818,16741799,38
45,Chr3,16755286,16755472,16755379,186
45,Chr5,541756,544105,542930,2349
45,Chr5,8049326,8049910,8049618,584
45,Chr5,21298409,21298738,21298573,329
46,Chr1,12548166,12548554,12548360,388
46,Chr2,1689177,1689193,1689185,16
46,Chr2,13801325,13802154,13801739,829
46,Chr2,15495246,15496362,15495804,1116
46,Chr3,9904097,9904514,9904305,417
46,Chr3,17401464,17401779,17401622,315
46,Chr3,19986782,19987515,19987148,733
46,Chr4,11175598,11176263,11175930,665
46,Chr4,17689673,17690743,17690208,1070
46,Chr5,15306324,15306433,15306378,109
46,Chr5,25652484,25652586,25652535,102
47,Chr1,19518388,19518410,19518399,22
47,Chr2,187990,189081,188536,1091
47,Chr2,1010510,1025524,1018017,15014
47,Chr2,11904561,11907623,11906092,3062
47,Chr3,10875442,10876286,10875864,844
47,Chr3,23350170,23350213,23350192,43
47,Chr5,13487195,13487255,13487225,60
47,Chr5,25796210,25797065,25796638,855
48,Chr1,9198319,9199132,9198725,813
48,Chr2,16160490,16161128,16160809,638
48,Chr3,5135037,5142262,5138649,7225
48,Chr3,9168041,9168769,9168405,728
48,Chr3,15971441,15971671,15971556,230
48,Chr4,84786,84910,84848,124
49,Chr1,24498087,24498100,24498093,13
49,Chr2,10906049,10906463,10906256,414
49,Chr2,16758307,16758925,16758616,618
49,Chr3,10386701,10386806,10386753,105
49,Chr4,87255,88852,88053,1597
49,Chr4,9253761,9253974,9253867,213
49,Chr5,7752439,7752565,7752502,126
49,Chr5,10038172,10038332,10038252,160
49,Chr5,18294786,18294842,18294814,56
5,Chr1,6772739,6773774,6773257,1035
5,Chr1,28651893,28724228,28688061,72335
5,Chr2,2921863,2924570,2923217,2707
5,Chr2,5920713,5920848,5920781,135
5,Chr2,18707094,18707175,18707134,81
5,Chr3,7095577,7095586,7095581,9
5,Chr3,8527639,8529020,8528329,1381
5,Chr3,21042731,21044970,21043851,2239
5,Chr4,7245915,7246191,7246053,276
5,Chr5,7814107,7814349,7814228,242
5,Chr5,17925525,17925970,17925747,445
50,Chr1,7782210,7782331,7782270,121
50,Chr1,19689774,19690184,19689979,410
50,Chr2,11546060,11548264,11547162,2204
50,Chr3,1943253,1943625,1943439,372
50,Chr3,22425734,22427183,22426458,1449
50,Chr5,16569086,16569470,16569278,384
51,Chr1,17183805,17184876,17184341,1071
51,Chr1,24647107,24647271,24647189,164
51,Chr2,18368547,18369011,18368779,464
51,Chr3,733797,734844,734321,1047
51,Chr3,10456270,10456659,10456464,389
51,Chr3,19510689,19511113,19510901,424
51,Chr4,5299784,5299895,5299840,111
51,Chr4,17738957,17739728,17739343,771
51,Chr5,364125,364651,364388,526
51,Chr5,15422094,15422607,15422350,513
52,Chr1,17871266,17874287,17872776,3021
52,Chr2,179610,179714,179662,104
52,Chr2,11777516,11777616,11777566,100
52,Chr3,734844,735507,735176,663
52,Chr3,11805979,11807309,11806644,1330
52,Chr5,4571158,4571938,4571548,780
52,Chr5,9717038,9717917,9717478,879
53,Chr1,2817741,2818949,2818345,1208
53,Chr1,8199854,8200339,8200096,485
53,Chr1,17209796,17210773,17210284,977
53,Chr2,2349277,2349405,2349341,128
53,Chr2,14199880,14200926,14200403,1046
53,Chr3,11285469,11285987,11285728,518
53,Chr5,9987837,9988118,9987977,281
53,Chr5,13661135,13661775,13661455,640
54,Chr3,2902404,2903098,2902751,694
54,Chr3,7579250,7579946,7579598,696
54,Chr3,16598787,16599738,16599263,951
54,Chr4,7247349,7247605,7247477,256
54,Chr4,17471258,17471914,17471586,656
54,Chr5,5228587,5229066,5228827,479
55,Chr1,27970848,27971578,27971213,730
55,Chr2,15192193,15192571,15192382,378
55,Chr3,9215529,9216876,9216203,1347
55,Chr3,20072455,20073157,20072806,702
55,Chr4,10060637,10064532,10062585,3895
55,Chr5,5139407,5141244,5140325,1837
55,Chr5,16034222,16034746,16034484,524
56,Chr1,624717,625021,624869,304
56,Chr1,23459762,23460129,23459946,367
56,Chr2,13985817,13989625,13987721,3808
56,Chr3,9510887,9511417,9511152,530
56,Chr3,9586791,9587171,9586981,380
56,Chr3,19606632,19606801,19606716,169
56,Chr4,7597666,7599328,7598497,1662
56,Chr4,8855202,8856384,8855793,1182
56,Chr5,6983666,6983851,6983758,185
57,Chr1,7672839,7675677,7674258,2838
57,Chr1,10550298,10550950,10550624,652
57,Chr1,22926579,22926615,22926597,36
57,Chr2,8577194,8578164,8577679,970
57,Chr2,15031314,15032935,15032124,1621
57,Chr3,16035643,16036800,16036221,1157
57,Chr4,5299784,5299895,5299840,111
57,Chr4,10716357,10716389,10716373,32
57,Chr5,21305440,21305507,21305474,67
58,Chr1,13260423,13263623,13262023,3200
58,Chr1,29498689,29498971,29498830,282
58,Chr3,1923274,1923571,1923422,297
58,Chr3,16953563,16954032,16953797,469
58,Chr4,17260240,17261086,17260663,846
58,Chr5,8850257,8855729,8852993,5472
58,Chr5,24099069,24099674,24099371,605
59,Chr1,20009215,20009678,20009447,463
59,Chr1,28385496,28385902,28385699,406
59,Chr3,1350879,1351276,1351077,397
59,Chr4,6255725,6255880,6255803,155
59,Chr5,10089881,10089894,10089887,13
6,Chr1,4954007,4966392,4960199,12385
6,Chr1,11224366,11224367,11224366,1
6,Chr1,13999225,15983742,14991483,1984517
6,Chr2,1694249,1696398,1695323,2149
6,Chr2,5418309,5418733,5418521,424
6,Chr2,14374454,14375065,14374760,611
6,Chr3,9649726,9649735,9649730,9
6,Chr3,11740513,11744206,11742359,3693
6,Chr4,491015,491702,491359,687
6,Chr4,16310481,16310825,16310653,344
6,Chr5,1871750,1872781,1872266,1031
6,Chr5,2370319,2371201,2370760,882
6,Chr5,16842379,16842897,16842638,518
60,Chr1,12046480,12061061,12053770,14581
60,Chr2,6801071,6801370,6801221,299
60,Chr2,12108662,12124196,12116429,15534
60,Chr3,16188732,16188893,16188812,161
61,Chr1,19689040,19689774,19689407,734
61,Chr2,4806175,4806437,4806306,262
61,Chr3,10824495,10824678,10824587,183
61,Chr4,6614870,6616103,6615486,1233
61,Chr4,13663919,13663986,13663953,67
61,Chr5,14224612,14225486,14225049,874
61,Chr5,21374129,21374492,21374311,363
62,Chr1,11349415,11349822,11349619,407
62,Chr2,7223548,7223725,7223636,177
62,Chr3,9403661,9403749,9403705,88
62,Chr3,10880449,10880944,10880697,495
62,Chr5,15340700,15340811,15340756,111
62,Chr5,25843548,25843784,25843666,236
63,Chr1,7382441,7383357,7382899,916
63,Chr1,9199132,9223223,9211178,24091
63,Chr2,17881639,17881666,17881653,27
63,Chr3,18889807,18889916,18889861,109
63,Chr4,216381,216421,216401,40
63,Chr5,1793122,1794213,1793668,1091
64,Chr3,9497141,9497880,9497511,739
64,Chr4,7377845,7378861,7378353,1016
64,Chr5,13880957,13882391,13881674,1434
64,Chr5,26614414,26614675,26614544,261
65,Chr1,17291011,17292338,17291675,1327
65,Chr2,18423076,18424276,18423676,1200
65,Chr3,11310913,11310968,11310941,55
65,Chr3,14811695,14812520,14812107,825
65,Chr4,11350128,11350133,11350130,5
65,Chr5,13462088,13462497,13462292,409
66,Chr1,7780266,7781619,7780942,1353
66,Chr3,9511167,9511417,9511292,250
66,Chr3,17254846,17258036,17256441,3190
66,Chr4,10808817,10809464,10809141,647
67,Chr1,18912214,18913201,18912708,987
67,Chr1,28415902,28416013,28415958,111
67,Chr2,7284846,7285844,7285345,998
67,Chr2,9565477,9566674,9566075,1197
67,Chr3,7932884,7933177,7933030,293
67,Chr3,18070553,18070648,18070601,95
67,Chr5,5437006,5437808,5437407,802
67,Chr5,20635400,20635986,20635693,586
68,Chr1,24225385,24225762,24225573,377
68,Chr1,26003001,26003849,26003425,848
68,Chr2,7368537,7368829,7368683,292
68,Chr2,9236896,9237050,9236973,154
68,Chr2,18598515,18598856,18598685,341
68,Chr3,7631723,7631768,7631745,45
68,Chr4,1045752,1047090,1046421,1338
68,Chr4,12996614,12996919,12996766,305
68,Chr5,1950465,1950801,1950633,336
68,Chr5,15756401,15756900,15756651,499
69,Chr1,4117805,4117961,4117883,156
69,Chr1,7154314,7157751,7156032,3437
69,Chr1,29445223,29445507,29445365,284
69,Chr1,30269327,30269554,30269441,227
69,Chr2,14261814,14262241,14262028,427
69,Chr4,1441275,1442599,1441937,1324
69,Chr5,5009848,5010089,5009968,241
69,Chr5,16663275,16665406,16664341,2131
69,Chr5,18484721,18485697,18485209,976
7,Chr1,447293,449560,448427,2267
7,Chr1,18040777,18041608,18041193,831
7,Chr2,2901362,2901400,2901381,38
7,Chr2,9923657,9932841,9928249,9184
7,Chr3,15983327,15983643,15983485,316
7,Chr4,119280,119731,119506,451
7,Chr4,17229322,17230031,17229676,709
7,Chr5,5274403,5274669,5274536,266
7,Chr5,8124369,8126021,8125195,1652
7,Chr5,24708574,24708947,24708760,373
70,Chr1,11211568,11211664,11211616,96
70,Chr1,26707715,26707843,26707779,128
70,Chr1,27302770,27303998,27303384,1228
70,Chr2,6778351,6778527,6778439,176
70,Chr3,8866812,8871215,8869014,4403
70,Chr4,1529163,1529792,1529477,629
70,Chr5,8797487,8799898,8798693,2411
71,Chr1,12608529,12609060,12608795,531
71,Chr3,979096,979508,979302,412
71,Chr4,6228870,6228939,6228904,69
71,Chr5,8031659,8032290,8031975,631
72,Chr2,14636043,14639192,14637617,3149
72,Chr2,16159875,16160490,16160183,615
73,Chr1,8225657,8225799,8225728,142
73,Chr1,16265633,16266209,16265921,576
73,Chr1,28921564,28922256,28921910,692
73,Chr2,334781,335140,334961,359
73,Chr2,6948869,6949037,6948953,168
73,Chr2,15933713,15940713,15937213,7000
73,Chr3,10360668,10360816,10360742,148
73,Chr5,2444535,2445031,2444783,496
73,Chr5,21868070,21868801,21868436,731
74,Chr1,12689105,12689440,12689273,335
74,Chr1,25973506,25973512,25973509,6
74,Chr3,9984358,9985049,9984704,691
74,Chr4,11529760,11529974,11529867,214
74,Chr4,14408326,14408797,14408562,471
74,Chr5,6443354,6445091,6444222,1737
74,Chr5,24955692,24955723,24955708,31
75,Chr1,8548974,8549074,8549024,100
75,Chr1,17856825,17857859,17857342,1034
75,Chr3,2771918,2772605,2772262,687
75,Chr3,9010138,9010421,9010280,283
75,Chr5,14894979,14895279,14895129,300
76,Chr1,23411381,23412778,23412079,1397
76,Chr2,277329,277351,277340,22
76,Chr2,7806798,7806934,7806866,136
76,Chr2,9969883,9971328,9970605,1445
76,Chr3,11840052,11840142,11840097,90
76,Chr5,10149458,10149673,10149566,215
76,Chr5,25802059,25803186,25802623,1127
77,Chr2,14587641,14587968,14587805,327
77,Chr3,12666294,12667008,12666651,714
77,Chr4,5727717,5729491,5728604,1774
77,Chr4,11668256,11668829,11668542,573
77,Chr4,15707178,15707281,15707230,103
77,Chr5,19288671,19290096,19289383,1425
77,Chr5,22415572,22416164,22415868,592
78,Chr1,2379063,2379353,2379208,290
78,Chr1,8919721,8920494,8920107,773
78,Chr1,22745677,22746133,22745905,456
78,Chr3,318326,321598,319962,3272
78,Chr3,17176147,17176464,17176305,317
78,Chr4,73968,75566,74767,1598
78,Chr5,13880565,13880739,13880652,174
78,Chr5,25908539,25909119,25908829,580
79,Chr1,16705466,16705799,16705632,333
79,Chr3,7645738,7646303,7646020,565
79,Chr4,5602025,5602110,5602067,85
79,Chr4,11652854,11653286,11653070,432
79,Chr5,15466962,15467140,15467051,178
8,Chr1,8146423,8146475,8146449,52
8,Chr1,8392782,8393239,8393010,457
8,Chr1,28234073,28234654,28234363,581
8,Chr2,2901400,2901696,2901548,296
8,Chr2,12332210,12333915,12333062,1705
8,Chr3,1065668,1066606,1066137,938
8,Chr4,17467919,17468311,17468115,392
8,Chr5,4158621,4159259,4158940,638
8,Chr5,26245196,26245810,26245503,614
80,Chr1,7200560,7200672,7200616,112
80,Chr2,4857364,4860794,4859079,3430
80,Chr2,6534941,6535539,6535240,598
80,Chr3,7990291,7990989,7990640,698
80,Chr3,17201617,17201945,17201781,328
80,Chr3,20592402,20592677,20592540,275
80,Chr4,8353964,8354002,8353983,38
80,Chr4,9744268,9745120,9744694,852
80,Chr5,1343884,1344131,1344008,247
81,Chr2,6354494,6354683,6354588,189
81,Chr2,14055424,14056103,14055764,679
81,Chr3,1177790,1178015,1177902,225
81,Chr3,4377450,4378346,4377898,896
81,Chr3,17550449,17551986,17551217,1537
81,Chr4,5848175,5849120,5848647,945
81,Chr4,17782455,17785282,17783869,2827
81,Chr5,13879924,13880021,13879972,97
81,Chr5,15421114,15421321,15421218,207
82,Chr1,3889462,3889545,3889504,83
82,Chr1,7481472,7481951,7481712,479
82,Chr1,29384847,29384987,29384917,140
82,Chr2,1028341,1028354,1028347,13
82,Chr2,6916796,6917861,6917328,1065
82,Chr3,15971441,15971671,15971556,230
82,Chr3,16890436,16891214,16890825,778
82,Chr4,6257385,6258844,6258115,1459
82,Chr5,4906326,4907488,4906907,1162
82,Chr5,7932446,7933094,7932770,648
82,Chr5,16512267,16512407,16512337,140
83,Chr1,16800944,16801304,16801124,360
83,Chr2,351126,351372,351249,246
83,Chr2,9987868,9988726,9988297,858
83,Chr3,20032777,20033176,20032977,399
83,Chr4,5365607,5365831,5365719,224
83,Chr4,16918803,16919338,16919071,535
83,Chr5,2324236,2324590,2324413,354
83,Chr5,17840009,17840636,17840323,627
83,Chr5,26885612,26886524,26886068,912
84,Chr1,4894949,4895565,4895257,616
84,Chr3,6331036,6332188,6331612,1152
84,Chr4,727364,727476,727420,112
84,Chr4,5831628,5834924,5833276,3296
84,Chr5,26221560,26222001,26221780,441
85,Chr1,9179774,9180073,9179924,299
85,Chr1,17702530,17702669,17702600,139
85,Chr2,7666858,7667617,7667238,759
85,Chr3,9136621,9136695,9136658,74
85,Chr3,11811507,11812031,11811769,524
85,Chr4,5424464,5424572,5424518,108
85,Chr4,11764527,11765010,11764769,483
85,Chr5,8382825,8383412,8383119,587
85,Chr5,17634874,17635462,17635168,588
86,Chr1,8535425,8537070,8536247,1645
86,Chr1,29501082,29501745,29501414,663
86,Chr2,6023891,6033611,6028751,9720
86,Chr2,9540969,9541253,9541111,284
86,Chr3,11738945,11739115,11739030,170
86,Chr3,15784011,15784188,15784099,177
86,Chr4,5143230,5143324,5143277,94
86,Chr4,6078009,6078161,6078085,152
86,Chr5,15229807,15231006,15230407,1199
87,Chr2,6467972,6468004,6467988,32
87,Chr2,16292266,16292569,16292418,303
87,Chr3,607850,608294,608072,444
87,Chr4,9443711,9444423,9444067,712
87,Chr4,17352525,17353680,17353103,1155
87,Chr5,14733403,14733988,14733695,585
88,Chr1,8718271,8719120,8718695,849
88,Chr1,16657727,16657879,16657803,152
88,Chr3,9484586,9485439,9485012,853
88,Chr3,9843072,9843371,9843222,299
88,Chr4,6747019,6747407,6747213,388
88,Chr4,17555445,17555462,17555453,17
88,Chr5,8659332,8659780,8659556,448
88,Chr5,16644193,16644427,16644310,234
89,Chr1,3578433,3578910,3578671,477
89,Chr1,16137863,16141442,16139653,3579
89,Chr1,23863264,23865339,23864302,2075
89,Chr2,5003869,5005611,5004740,1742
89,Chr3,7224746,7225490,7225118,744
89,Chr3,10419436,10419623,10419530,187
89,Chr4,9391970,9392400,9392185,430
89,Chr5,20440705,20440885,20440795,180
9,Chr1,1976789,1976873,1976831,84
9,Chr1,11864161,11865813,11864987,1652
9,Chr2,104435,105849,105142,1414
9,Chr2,2181296,2182064,2181680,768
9,Chr3,3224228,3225051,3224640,823
9,Chr3,4788713,4788839,4788776,126
9,Chr3,7845128,7851454,7848291,6326
9,Chr3,21453235,21465064,21459149,11829
9,Chr5,6224878,6224981,6224930,103
9,Chr5,25755295,25755658,25755477,363
90,Chr1,16737235,16737379,16737307,144
90,Chr2,826879,827159,827019,280
90,Chr2,9562697,9563116,9562907,419
90,Chr3,4778878,4779485,4779182,607
90,Chr4,16930267,16930916,16930591,649
90,Chr5,20052165,20053529,20052847,1364
90,Chr5,20841237,20841312,20841275,75
90,Chr5,22129686,22137615,22133650,7929
91,Chr1,9005247,9015851,9010549,10604
91,Chr1,24538166,24538388,24538277,222
91,Chr1,28855811,28856017,28855914,206
91,Chr2,1106691,1107733,1107212,1042
91,Chr2,6688048,6688548,6688298,500
91,Chr2,13949565,13950401,13949983,836
91,Chr3,7598267,7598759,7598513,492
91,Chr3,15081971,15082065,15082018,94
91,Chr4,9309859,9310284,9310071,425
91,Chr4,16563229,16563366,16563297,137
91,Chr4,17992357,17998829,17995593,6472
91,Chr5,5710856,5711678,5711267,822
91,Chr5,8879196,8882198,8880697,3002
91,Chr5,21579558,21579614,21579586,56
91,Chr5,26757135,26757636,26757385,501
92,Chr1,21695696,21695885,21695790,189
92,Chr1,23802518,23803153,23802836,635
92,Chr2,350665,351126,350895,461
92,Chr2,13151980,13152474,13152227,494
92,Chr3,5371646,5372409,5372028,763
92,Chr4,5365454,5365591,5365522,137
92,Chr4,6448805,6449092,6448949,287
92,Chr4,17629291,17629338,17629315,47
92,Chr5,1770444,1770823,1770634,379
92,Chr5,7229366,7229441,7229404,75
93,Chr1,559506,560551,560028,1045
93,Chr1,9458448,9458722,9458585,274
93,Chr1,25274320,25275454,25274887,1134
93,Chr2,10169625,10170007,10169816,382
93,Chr3,8236471,8237061,8236766,590
93,Chr4,5740037,5740385,5740211,348
93,Chr4,6207583,6209747,6208665,2164
93,Chr5,2120153,2120472,2120313,319
93,Chr5,26350212,26350402,26350307,190
94,Chr1,21519119,21519591,21519355,472
94,Chr2,7252168,7252380,7252274,212
94,Chr4,4868023,4870041,4869032,2018
95,Chr1,3938146,4010265,3974206,72119
95,Chr1,25027501,25031220,25029361,3719
95,Chr3,9719306,9719521,9719414,215
95,Chr3,11148048,11148876,11148462,828
95,Chr5,7967682,7967914,7967798,232
96,Chr2,9372067,9373865,9372966,1798
96,Chr2,15587615,15588556,15588085,941
96,Chr3,20406439,20406781,20406610,342
96,Chr4,9182671,9194706,9188689,12035
96,Chr5,22376802,22376947,22376874,145
