lib,chrs,start,stop,cos,width
1,Chr1,8134618,8135511,8135064,893
1,Chr2,184151,184448,184299,297
1,Chr2,10384934,10386737,10385836,1803
1,Chr4,10108684,10109065,10108874,381
1,Chr5,7387125,7387339,7387232,214
1,Chr5,17447631,17447791,17447711,160
10,Chr1,3571434,3571773,3571604,339
10,Chr1,7406788,7407649,7407218,861
10,Chr1,12257855,12257986,12257921,131
10,Chr1,18554457,18554598,18554527,141
10,Chr1,25706351,25710934,25708643,4583
10,Chr1,30391616,30392236,30391926,620
10,Chr2,7522123,7522799,7522461,676
10,Chr2,11275256,11275943,11275600,687
10,Chr3,1094460,1094604,1094532,144
10,Chr3,19643212,19643954,19643583,742
10,Chr4,5724993,5725089,5725041,96
10,Chr4,9343612,9343624,9343618,12
10,Chr5,880193,881436,880815,1243
10,Chr5,16631343,16631466,16631405,123
11,Chr1,22987479,22990258,22988869,2779
11,Chr2,6758172,6758522,6758347,350
11,Chr2,15132956,15133395,15133176,439
11,Chr3,8512518,8514638,8513578,2120
11,Chr3,16007298,16007343,16007320,45
11,Chr4,1260499,1261656,1261077,1157
11,Chr5,6554060,6554206,6554133,146
11,Chr5,18704431,18704771,18704601,340
11,Chr5,21514724,21514849,21514786,125
11,Chr5,25735362,25736270,25735816,908
11,Chr5,26157415,26158033,26157724,618
12,Chr1,10010941,10012101,10011521,1160
12,Chr1,11202657,11202793,11202725,136
12,Chr1,21420020,21420555,21420288,535
12,Chr1,29104074,29107274,29105674,3200
12,Chr2,12871471,12871691,12871581,220
12,Chr3,22783710,22783739,22783724,29
12,Chr4,6424545,6425346,6424945,801
12,Chr4,12332606,12332632,12332619,26
12,Chr5,4946869,4946908,4946889,39
12,Chr5,16871945,16872287,16872116,342
12,Chr5,21971317,21971571,21971444,254
13,Chr1,7342023,7342481,7342252,458
13,Chr1,25568060,25568253,25568156,193
13,Chr2,7840802,7841080,7840941,278
13,Chr3,2752906,2757112,2755009,4206
13,Chr3,8619499,8619766,8619633,267
13,Chr4,5709729,5710119,5709924,390
13,Chr5,4958282,4960223,4959252,1941
13,Chr5,24082149,24082800,24082475,651
14,Chr1,3727779,3728128,3727953,349
14,Chr1,17900048,17900127,17900088,79
14,Chr2,8706839,8706906,8706873,67
14,Chr3,9531921,9532471,9532196,550
14,Chr3,16885817,16886171,16885994,354
14,Chr4,10713555,10713578,10713567,23
14,Chr4,11828074,11828265,11828170,191
14,Chr5,9712714,9712752,9712733,38
15,Chr1,23267646,23268269,23267958,623
15,Chr2,12009421,12010188,12009805,767
15,Chr3,4746849,4747120,4746985,271
15,Chr3,10144045,10144141,10144093,96
15,Chr3,20418007,20418124,20418065,117
15,Chr4,8882170,8882390,8882280,220
15,Chr5,5301321,5301461,5301391,140
15,Chr5,22277559,22278703,22278131,1144
16,Chr1,8308193,8308560,8308377,367
16,Chr1,19973483,19974306,19973895,823
16,Chr1,27139393,27141059,27140226,1666
16,Chr2,12962714,12962856,12962785,142
16,Chr2,14983338,14983437,14983388,99
16,Chr3,18515877,18516310,18516093,433
16,Chr3,20695766,20696695,20696230,929
16,Chr4,841652,841818,841735,166
16,Chr4,7729653,7729772,7729713,119
16,Chr4,17157768,17158175,17157972,407
16,Chr5,2130143,2130491,2130317,348
16,Chr5,22571842,22573256,22572549,1414
17,Chr1,5539499,5539807,5539653,308
17,Chr1,22319550,22321356,22320453,1806
17,Chr2,1059459,1059538,1059499,79
17,Chr2,9340518,9341893,9341206,1375
17,Chr2,9753965,9754000,9753983,35
17,Chr2,16030191,16030530,16030361,339
17,Chr3,953374,954306,953840,932
17,Chr4,16742996,16743047,16743022,51
17,Chr5,4484697,4485229,4484963,532
17,Chr5,7013144,7013175,7013160,31
17,Chr5,15131942,15132258,15132100,316
17,Chr5,22850127,22850139,22850133,12
17,Chr5,26280965,26281017,26280991,52
18,Chr1,24631883,24632225,24632054,342
18,Chr1,28972720,28975601,28974160,2881
18,Chr2,8333300,8333707,8333504,407
18,Chr2,9905177,9905215,9905196,38
18,Chr2,11857425,11859173,11858299,1748
18,Chr3,285236,286076,285656,840
18,Chr3,19192218,19192458,19192338,240
18,Chr4,5373673,5373979,5373826,306
18,Chr4,7321577,7322020,7321799,443
18,Chr4,7911566,7911956,7911761,390
18,Chr4,11271158,11271923,11271540,765
18,Chr5,2318157,2318617,2318387,460
18,Chr5,10659245,10659275,10659260,30
18,Chr5,19969947,19970772,19970359,825
19,Chr1,8060291,8060647,8060469,356
19,Chr1,11815290,11815778,11815534,488
19,Chr1,21321885,21321900,21321893,15
19,Chr1,30280707,30280986,30280847,279
19,Chr2,8026106,8026645,8026376,539
19,Chr2,10549562,10549875,10549718,313
19,Chr2,15382337,15382365,15382351,28
19,Chr3,3070215,3071038,3070627,823
19,Chr3,10591426,10591461,10591444,35
19,Chr3,18808624,18808966,18808795,342
19,Chr4,278040,278364,278202,324
19,Chr4,9401251,9401286,9401269,35
19,Chr4,17466311,17466893,17466602,582
19,Chr5,947184,948924,948054,1740
19,Chr5,2031957,2032868,2032413,911
19,Chr5,15757694,15757740,15757717,46
2,Chr1,5876539,5876608,5876573,69
2,Chr1,7843632,7843998,7843815,366
2,Chr1,20431340,20431467,20431404,127
2,Chr2,2322170,2322601,2322386,431
2,Chr3,3651457,3652132,3651795,675
2,Chr3,22382411,22391622,22387017,9211
2,Chr4,367468,367819,367644,351
2,Chr4,14408326,14408797,14408562,471
2,Chr5,8970503,8981546,8976025,11043
2,Chr5,19797294,19800748,19799021,3454
20,Chr1,7491737,7491756,7491747,19
20,Chr1,10708250,10708275,10708262,25
20,Chr1,12250008,12250429,12250218,421
20,Chr2,8104251,8105171,8104711,920
20,Chr2,10196096,10197671,10196884,1575
20,Chr2,18819833,18820408,18820121,575
20,Chr3,3130582,3130844,3130713,262
20,Chr3,8124296,8125246,8124771,950
20,Chr3,10993439,10993469,10993454,30
20,Chr3,20315010,20317049,20316030,2039
20,Chr4,1030745,1031358,1031051,613
20,Chr4,12965613,12966506,12966059,893
20,Chr5,7752283,7752439,7752361,156
21,Chr1,11015036,11015100,11015068,64
21,Chr1,23367624,23367656,23367640,32
21,Chr2,12283272,12283768,12283520,496
21,Chr2,17290948,17311215,17301082,20267
21,Chr4,658198,658358,658278,160
21,Chr4,7924918,7924936,7924927,18
21,Chr5,10292148,10292522,10292335,374
21,Chr5,13865992,13866410,13866201,418
22,Chr1,9259232,9260438,9259835,1206
22,Chr1,10045695,10046578,10046137,883
22,Chr1,19556995,19557024,19557009,29
22,Chr1,21144876,21145092,21144984,216
22,Chr1,25318917,25319517,25319217,600
22,Chr2,289902,290715,290308,813
22,Chr2,11688106,11688177,11688142,71
22,Chr3,323720,324242,323981,522
22,Chr3,23161891,23162438,23162165,547
22,Chr4,16565580,16565643,16565612,63
22,Chr5,2006913,2007745,2007329,832
22,Chr5,18989673,18989730,18989701,57
22,Chr5,20474479,20474798,20474639,319
23,Chr1,8702166,8703142,8702654,976
23,Chr1,16133722,16134080,16133901,358
23,Chr1,23117365,23117680,23117523,315
23,Chr1,24223865,24223963,24223914,98
23,Chr2,6833230,6833577,6833404,347
23,Chr2,11098534,11099246,11098890,712
23,Chr2,17230714,17234087,17232400,3373
23,Chr3,2253489,2253523,2253506,34
23,Chr3,17910476,17910706,17910591,230
23,Chr4,8857712,8857993,8857852,281
23,Chr4,17658182,17658972,17658577,790
23,Chr4,18519547,18521001,18520274,1454
23,Chr5,8705987,8706711,8706349,724
23,Chr5,21852876,21853203,21853040,327
23,Chr5,25904782,25904809,25904796,27
24,Chr1,8599719,8599727,8599723,8
24,Chr1,29957835,29962226,29960031,4391
24,Chr2,16418564,16418746,16418655,182
24,Chr3,5479537,5479869,5479703,332
24,Chr3,21500363,21513104,21506733,12741
24,Chr3,22712568,22712715,22712642,147
24,Chr4,6439403,6439897,6439650,494
24,Chr4,11918666,11919949,11919308,1283
24,Chr5,7971944,7972225,7972084,281
25,Chr1,18128622,18129787,18129204,1165
25,Chr1,29489384,29489466,29489425,82
25,Chr2,391724,393300,392512,1576
25,Chr2,8911133,8911390,8911261,257
25,Chr2,19217319,19217919,19217619,600
25,Chr3,3606087,3606272,3606179,185
25,Chr3,11002619,11003040,11002829,421
25,Chr3,17478713,17479003,17478858,290
25,Chr4,7404331,7406869,7405600,2538
25,Chr5,8035827,8036417,8036122,590
25,Chr5,20802806,20802935,20802870,129
26,Chr1,7665786,7665806,7665796,20
26,Chr1,11314895,11318153,11316524,3258
26,Chr1,21887740,21887792,21887766,52
26,Chr1,27834044,27834373,27834208,329
26,Chr2,2322170,2322601,2322386,431
26,Chr2,15192193,15192571,15192382,378
26,Chr3,1221695,1221912,1221803,217
26,Chr3,20471165,20471922,20471543,757
26,Chr4,17633076,17633225,17633150,149
26,Chr5,733600,734018,733809,418
26,Chr5,22183173,22183419,22183296,246
27,Chr1,19615342,19617482,19616412,2140
27,Chr1,20774961,20775072,20775017,111
27,Chr1,25695371,25695774,25695573,403
27,Chr2,397692,397738,397715,46
27,Chr2,12766466,12766743,12766604,277
27,Chr2,17243649,17243652,17243651,3
27,Chr3,1845347,1845467,1845407,120
27,Chr3,3414256,3415548,3414902,1292
27,Chr4,676085,676616,676351,531
27,Chr4,10075524,10076287,10075906,763
27,Chr4,16260138,16260607,16260372,469
27,Chr5,4426143,4427543,4426843,1400
27,Chr5,24683939,24690168,24687053,6229
28,Chr1,8653403,8653578,8653491,175
28,Chr2,7414701,7414846,7414773,145
28,Chr2,8383687,8383890,8383789,203
28,Chr2,15718934,15719091,15719012,157
28,Chr2,19393860,19394113,19393986,253
28,Chr3,19501352,19501407,19501380,55
28,Chr4,5447789,5448146,5447967,357
28,Chr4,6416513,6416737,6416625,224
28,Chr5,20728977,20743993,20736485,15016
28,Chr5,25656566,25656861,25656714,295
28,Chr5,26229856,26229959,26229908,103
29,Chr1,23799343,23800341,23799842,998
29,Chr1,27537044,27537234,27537139,190
29,Chr2,12807604,12807644,12807624,40
29,Chr2,18557289,18559004,18558147,1715
29,Chr3,2510465,2512365,2511415,1900
29,Chr4,651345,651556,651451,211
29,Chr4,17050722,17051775,17051248,1053
29,Chr5,2193651,2193836,2193743,185
3,Chr1,29358661,29358745,29358703,84
3,Chr2,7803085,7803108,7803097,23
3,Chr4,5659804,5660121,5659962,317
3,Chr5,23226922,23226975,23226948,53
30,Chr1,9387685,9387715,9387700,30
30,Chr1,9839668,9839713,9839690,45
30,Chr1,28441219,28441659,28441439,440
30,Chr1,28913645,28914399,28914022,754
30,Chr2,756193,756251,756222,58
30,Chr3,1455461,1456526,1455993,1065
30,Chr3,17590969,17591206,17591087,237
30,Chr4,13339272,13339878,13339575,606
30,Chr4,17536814,17537246,17537030,432
30,Chr5,629706,629738,629722,32
30,Chr5,20291884,20293412,20292648,1528
31,Chr1,5005687,5008849,5007268,3162
31,Chr1,8346100,8346456,8346278,356
31,Chr1,25250334,25250563,25250448,229
31,Chr2,9391274,9391856,9391565,582
31,Chr3,15406152,15406362,15406257,210
31,Chr4,1271659,1272732,1272195,1073
32,Chr1,6947055,6949353,6948204,2298
32,Chr1,26619364,26620446,26619905,1082
32,Chr3,2093491,2093848,2093669,357
32,Chr3,11106563,11106714,11106639,151
32,Chr3,15905120,15905195,15905158,75
32,Chr3,19868971,19869365,19869168,394
32,Chr4,5577313,5579123,5578218,1810
32,Chr4,14270608,14270717,14270662,109
32,Chr5,7808387,7808394,7808391,7
32,Chr5,17781875,17782603,17782239,728
32,Chr5,20564381,20571745,20568063,7364
33,Chr1,21016801,21017506,21017153,705
33,Chr3,1450366,1450481,1450424,115
33,Chr3,23194373,23195662,23195017,1289
33,Chr4,9755056,9755617,9755336,561
33,Chr4,14107044,14107880,14107462,836
33,Chr5,20920890,20921629,20921260,739
33,Chr5,24708241,24708452,24708347,211
34,Chr1,18779389,18779403,18779396,14
34,Chr2,7422288,7422501,7422394,213
34,Chr3,6784515,6784771,6784643,256
34,Chr3,19269233,19269609,19269421,376
34,Chr4,403483,404455,403969,972
34,Chr4,8297964,8298041,8298002,77
34,Chr4,16315175,16315806,16315491,631
34,Chr5,18680770,18680840,18680805,70
35,Chr1,2452973,2453600,2453287,627
35,Chr1,29231415,29231859,29231637,444
35,Chr2,8887067,8887366,8887217,299
35,Chr3,1837291,1837739,1837515,448
35,Chr3,8228254,8228398,8228326,144
35,Chr3,19701950,19702282,19702116,332
35,Chr4,404455,405794,405125,1339
36,Chr1,7490644,7490936,7490790,292
36,Chr2,6288955,6289522,6289239,567
36,Chr2,15494148,15494831,15494490,683
36,Chr2,18820408,18820510,18820459,102
36,Chr3,3127798,3128048,3127923,250
36,Chr3,8129056,8129407,8129232,351
36,Chr3,10993303,10993406,10993355,103
36,Chr4,1032219,1032580,1032399,361
36,Chr4,5427613,5427850,5427731,237
36,Chr4,6937043,6937197,6937120,154
36,Chr4,17250169,17250251,17250210,82
36,Chr5,1116806,1117423,1117114,617
36,Chr5,6193969,6195418,6194693,1449
37,Chr1,6880059,6881798,6880929,1739
37,Chr1,28107813,28108077,28107945,264
37,Chr2,9563549,9563936,9563743,387
37,Chr2,15778117,15779367,15778742,1250
37,Chr3,7867266,7868437,7867852,1171
37,Chr3,16924542,16924683,16924612,141
37,Chr3,18242886,18242954,18242920,68
37,Chr4,10929265,10929763,10929514,498
37,Chr5,1050521,1051222,1050871,701
37,Chr5,8670593,8671138,8670865,545
37,Chr5,18607864,18608146,18608005,282
37,Chr5,25653943,25654273,25654108,330
38,Chr1,850465,858097,854281,7632
38,Chr1,13403607,13403676,13403641,69
38,Chr3,4986553,4986651,4986602,98
38,Chr3,7751524,7754506,7753015,2982
38,Chr4,7341111,7341147,7341129,36
38,Chr5,22558285,22559304,22558795,1019
39,Chr1,4173431,4175358,4174395,1927
39,Chr1,6885199,6885288,6885243,89
39,Chr1,19537477,19537931,19537704,454
39,Chr2,115251,115565,115408,314
39,Chr2,16926327,16926404,16926365,77
39,Chr3,5356133,5357549,5356841,1416
39,Chr3,6796060,6796432,6796246,372
39,Chr4,9253974,9254191,9254082,217
39,Chr4,16959991,16960080,16960035,89
39,Chr5,2593873,2594239,2594056,366
39,Chr5,9648541,9648922,9648731,381
39,Chr5,14518136,14518634,14518385,498
39,Chr5,22323566,22324786,22324176,1220
4,Chr1,3552563,3554155,3553359,1592
4,Chr1,4857771,4859205,4858488,1434
4,Chr1,7451562,7452152,7451857,590
4,Chr1,9692750,9693159,9692954,409
4,Chr1,23403923,23403928,23403925,5
4,Chr2,1129228,1129835,1129532,607
4,Chr2,6501775,6501932,6501853,157
4,Chr2,10840217,10840342,10840279,125
4,Chr2,15188986,15189469,15189228,483
4,Chr3,22790819,22791165,22790992,346
4,Chr4,17676308,17676844,17676576,536
4,Chr5,507170,507439,507304,269
4,Chr5,14757728,14757844,14757786,116
4,Chr5,20232289,20232331,20232310,42
40,Chr1,5510088,5513582,5511835,3494
40,Chr1,12473408,12473847,12473628,439
40,Chr1,25223599,25225443,25224521,1844
40,Chr1,28366063,28367935,28366999,1872
40,Chr4,10257222,10257267,10257244,45
40,Chr4,12492856,12493471,12493164,615
40,Chr5,4939341,4944539,4941940,5198
40,Chr5,17526842,17527056,17526949,214
40,Chr5,22378463,22378767,22378615,304
41,Chr1,5439448,5439452,5439450,4
41,Chr1,27172376,27173107,27172742,731
41,Chr3,9497318,9497880,9497599,562
41,Chr3,23165361,23165814,23165587,453
41,Chr4,5758681,5758925,5758803,244
41,Chr4,8582114,8583191,8582652,1077
41,Chr4,16295149,16296236,16295693,1087
41,Chr5,14710675,14710992,14710833,317
42,Chr1,23820692,23821083,23820888,391
42,Chr1,25430619,25430942,25430781,323
42,Chr2,7411480,7411810,7411645,330
42,Chr2,9882658,9882673,9882666,15
42,Chr3,22758960,22759939,22759450,979
42,Chr4,10653678,10653743,10653710,65
42,Chr4,18320362,18321510,18320936,1148
42,Chr5,6743014,6744948,6743981,1934
42,Chr5,19646600,19646857,19646728,257
43,Chr1,159941,160515,160228,574
43,Chr1,5508567,5508718,5508643,151
43,Chr1,17429411,17429836,17429623,425
43,Chr1,20448985,20449398,20449191,413
43,Chr1,22215414,22215835,22215624,421
43,Chr2,6868042,6868979,6868510,937
43,Chr2,13950401,13950699,13950550,298
43,Chr3,4112416,4112559,4112488,143
43,Chr3,4883280,4883417,4883348,137
43,Chr3,7905366,7905610,7905488,244
43,Chr3,17604017,17604131,17604074,114
43,Chr3,23014282,23014712,23014497,430
43,Chr4,81364,82605,81984,1241
43,Chr4,1260499,1261656,1261077,1157
43,Chr4,7255668,7255750,7255709,82
43,Chr4,11349853,11350058,11349955,205
43,Chr5,4909514,4909902,4909708,388
43,Chr5,9969044,9969375,9969210,331
44,Chr1,1800016,1810771,1805394,10755
44,Chr1,11093302,11093853,11093578,551
44,Chr1,13224705,13225270,13224987,565
44,Chr2,12562610,12562736,12562673,126
44,Chr2,17365827,17369608,17367717,3781
44,Chr3,8042777,8042828,8042803,51
44,Chr5,1912351,1917207,1914779,4856
44,Chr5,8999818,9000138,8999978,320
44,Chr5,16834584,16835194,16834889,610
44,Chr5,22864621,22864924,22864773,303
45,Chr1,2191797,2192375,2192086,578
45,Chr1,23022124,23022350,23022237,226
45,Chr2,12293246,12294066,12293656,820
45,Chr2,15947700,15947832,15947766,132
45,Chr3,4819230,4822497,4820864,3267
45,Chr3,9700976,9701212,9701094,236
45,Chr5,879230,879583,879406,353
45,Chr5,4653396,4655788,4654592,2392
46,Chr1,559506,560551,560028,1045
46,Chr1,8340841,8341205,8341023,364
46,Chr2,6160418,6161441,6160930,1023
46,Chr2,7323745,7323949,7323847,204
46,Chr2,18370469,18371800,18371135,1331
46,Chr3,1095227,1095473,1095350,246
46,Chr3,17279117,17279184,17279151,67
46,Chr3,22324128,22331817,22327972,7689
46,Chr4,7542507,7543018,7542763,511
46,Chr4,7960097,7960708,7960403,611
46,Chr4,14207234,14208207,14207720,973
46,Chr5,8024544,8024717,8024630,173
46,Chr5,19571003,19571589,19571296,586
46,Chr5,24238548,24239998,24239273,1450
47,Chr1,662857,662928,662893,71
47,Chr1,7013234,7013277,7013256,43
47,Chr1,12180029,12181045,12180537,1016
47,Chr1,21231441,21231912,21231677,471
47,Chr1,27710638,27710667,27710652,29
47,Chr2,17444327,17445044,17444685,717
47,Chr3,20589764,20590706,20590235,942
47,Chr4,8832547,8833272,8832909,725
47,Chr5,3031932,3044373,3038152,12441
47,Chr5,17033233,17033479,17033356,246
47,Chr5,24673112,24673580,24673346,468
48,Chr1,6461139,6461329,6461234,190
48,Chr1,11191794,11192300,11192047,506
48,Chr1,18322695,18322930,18322813,235
48,Chr1,24734133,24734188,24734161,55
48,Chr1,27042940,27043109,27043024,169
48,Chr2,6300427,6300797,6300612,370
48,Chr2,9126963,9127078,9127021,115
48,Chr3,7362159,7362707,7362433,548
48,Chr3,9992545,9992714,9992629,169
48,Chr3,11085472,11087101,11086286,1629
48,Chr3,17423269,17423652,17423461,383
48,Chr4,10961552,10961565,10961558,13
48,Chr5,3460649,3461513,3461081,864
48,Chr5,5956761,5956989,5956875,228
48,Chr5,8609832,8610147,8609990,315
49,Chr1,1538318,1539269,1538794,951
49,Chr1,12478723,12478800,12478761,77
49,Chr1,19911633,19912314,19911973,681
49,Chr2,12338968,12339408,12339188,440
49,Chr2,15960892,15961327,15961110,435
49,Chr3,7912730,7912735,7912732,5
49,Chr3,8685648,8685786,8685717,138
49,Chr4,12841325,12841359,12841342,34
49,Chr4,16101932,16102061,16101996,129
49,Chr5,6714544,6717310,6715927,2766
49,Chr5,19149863,19149904,19149883,41
5,Chr1,2810902,2811983,2811442,1081
5,Chr1,3553135,3554155,3553645,1020
5,Chr1,18131072,18131182,18131127,110
5,Chr3,4618277,4618661,4618469,384
5,Chr4,487672,487855,487764,183
5,Chr5,1257856,1258355,1258106,499
5,Chr5,24766130,24766146,24766138,16
50,Chr1,4187986,4188341,4188164,355
50,Chr1,18077810,18077977,18077894,167
50,Chr2,807925,807943,807934,18
50,Chr2,17848035,17848787,17848411,752
50,Chr3,16968663,16969374,16969019,711
50,Chr3,22425734,22427183,22426458,1449
50,Chr4,1271408,1271428,1271418,20
50,Chr4,5602257,5602487,5602372,230
50,Chr4,12084668,12084892,12084780,224
50,Chr5,26585549,26586211,26585880,662
51,Chr1,18269162,18269186,18269174,24
51,Chr1,26794442,26794852,26794647,410
51,Chr1,28630915,28631772,28631343,857
51,Chr2,7712619,7712869,7712744,250
51,Chr2,15095941,15096895,15096418,954
51,Chr2,18563625,18563894,18563759,269
51,Chr4,6499944,6500067,6500006,123
51,Chr5,21892310,21892677,21892494,367
51,Chr5,23365669,23365801,23365735,132
51,Chr5,25795583,25796210,25795897,627
52,Chr1,4193806,4194580,4194193,774
52,Chr1,12235937,12236208,12236073,271
52,Chr1,13077389,13077492,13077441,103
52,Chr1,27563500,27563527,27563514,27
52,Chr2,1492196,1492260,1492228,64
52,Chr2,19392568,19393559,19393064,991
52,Chr4,10381379,10381861,10381620,482
52,Chr4,15964192,15964924,15964558,732
53,Chr1,16132662,16132664,16132663,2
53,Chr1,23244460,23245177,23244818,717
53,Chr2,1602628,1602760,1602694,132
53,Chr2,6299234,6299247,6299240,13
53,Chr3,576758,577067,576912,309
53,Chr3,17274247,17274458,17274353,211
53,Chr3,18666308,18667187,18666748,879
53,Chr3,23229739,23242592,23236165,12853
53,Chr4,1045635,1045752,1045693,117
53,Chr4,13970888,13971279,13971084,391
53,Chr5,7859346,7859523,7859434,177
53,Chr5,19226793,19231171,19228982,4378
53,Chr5,22573495,22573961,22573728,466
54,Chr1,26181853,26183278,26182565,1425
54,Chr2,2322170,2322601,2322386,431
54,Chr2,11830087,11830894,11830491,807
54,Chr2,16284134,16284195,16284164,61
54,Chr4,14141707,14141833,14141770,126
54,Chr5,7111750,7113177,7112464,1427
54,Chr5,18227804,18227981,18227892,177
55,Chr1,5132334,5132391,5132362,57
55,Chr2,14425451,14425775,14425613,324
55,Chr4,6720809,6721955,6721382,1146
55,Chr4,16043636,16043776,16043706,140
55,Chr5,18165188,18165263,18165226,75
56,Chr1,11578028,11578059,11578044,31
56,Chr2,1693043,1693087,1693065,44
56,Chr2,10837241,10837473,10837357,232
56,Chr2,12625995,12626731,12626363,736
56,Chr3,4045136,4045875,4045506,739
56,Chr3,16227545,16230006,16228775,2461
56,Chr4,661622,662004,661813,382
56,Chr4,12260968,12261572,12261270,604
56,Chr5,8989270,8989611,8989440,341
56,Chr5,22560279,22560494,22560387,215
57,Chr1,18131661,18131740,18131701,79
57,Chr1,20527099,20529530,20528315,2431
57,Chr1,24431873,24432050,24431961,177
57,Chr2,8178852,8179319,8179086,467
57,Chr3,4934019,4934052,4934035,33
57,Chr3,16406329,16407072,16406701,743
57,Chr4,9253974,9254191,9254082,217
57,Chr5,2061435,2062433,2061934,998
57,Chr5,10183777,10183954,10183865,177
57,Chr5,17920522,17920730,17920626,208
57,Chr5,21718173,21718430,21718301,257
58,Chr1,5521110,5522028,5521569,918
58,Chr1,27320351,27321333,27320842,982
58,Chr2,112950,113118,113034,168
58,Chr3,10724701,10724793,10724747,92
58,Chr3,19432651,19436386,19434519,3735
58,Chr4,12903715,12904168,12903941,453
58,Chr5,8771426,8771721,8771574,295
58,Chr5,21100752,21102530,21101641,1778
58,Chr5,26883005,26883569,26883287,564
59,Chr1,2414206,2414916,2414561,710
59,Chr2,8425784,8426323,8426054,539
59,Chr2,17446407,17446769,17446588,362
59,Chr3,5685495,5685777,5685636,282
59,Chr3,10365153,10366180,10365667,1027
59,Chr5,4459532,4459811,4459672,279
59,Chr5,8599994,8600801,8600398,807
59,Chr5,25528588,25529163,25528876,575
6,Chr1,2244707,2245324,2245015,617
6,Chr1,4680829,4690603,4685716,9774
6,Chr1,12711345,12711443,12711394,98
6,Chr1,19862465,19862536,19862501,71
6,Chr1,23779808,23779868,23779838,60
6,Chr1,29495433,29495984,29495709,551
6,Chr3,2879875,2879955,2879915,80
6,Chr3,18576751,18577156,18576953,405
6,Chr4,9741190,9741507,9741348,317
6,Chr4,17267618,17268229,17267924,611
6,Chr5,7305500,7305633,7305566,133
6,Chr5,8619720,8620150,8619935,430
6,Chr5,22388614,22388774,22388694,160
6,Chr5,25094158,25094556,25094357,398
60,Chr1,5874436,5874920,5874678,484
60,Chr1,29383729,29383782,29383755,53
60,Chr2,2242896,2243035,2242966,139
60,Chr2,10451558,10454122,10452840,2564
60,Chr2,13743097,13743891,13743494,794
60,Chr3,3676602,3677170,3676886,568
60,Chr3,6044548,6044762,6044655,214
60,Chr4,9742569,9744268,9743419,1699
60,Chr4,15634561,15634801,15634681,240
60,Chr4,17527160,17527412,17527286,252
60,Chr5,15847449,15847725,15847587,276
61,Chr1,1173418,1173716,1173567,298
61,Chr1,6303033,6303170,6303101,137
61,Chr1,13076966,13077108,13077037,142
61,Chr1,23255435,23255456,23255445,21
61,Chr2,11224361,11224633,11224497,272
61,Chr3,3128391,3129249,3128820,858
61,Chr5,3017223,3017258,3017241,35
61,Chr5,10495263,10495445,10495354,182
61,Chr5,25334716,25335522,25335119,806
62,Chr1,559506,560551,560028,1045
62,Chr1,2476258,2477381,2476820,1123
62,Chr1,7945893,7946366,7946129,473
62,Chr1,11594425,11594555,11594490,130
62,Chr1,22071557,22072012,22071785,455
62,Chr1,25740148,25740666,25740407,518
62,Chr1,29366830,29367876,29367353,1046
62,Chr2,16069565,16069881,16069723,316
62,Chr3,323535,323623,323579,88
62,Chr3,20719366,20719532,20719449,166
62,Chr4,6353340,6353444,6353392,104
62,Chr4,12003751,12003987,12003869,236
62,Chr5,26289259,26289368,26289313,109
63,Chr1,5454605,5454727,5454666,122
63,Chr1,7464089,7465117,7464603,1028
63,Chr1,19593491,19593570,19593531,79
63,Chr2,1151284,1151513,1151398,229
63,Chr2,13808021,13808112,13808067,91
63,Chr3,2517938,2518895,2518416,957
63,Chr4,7781259,7782731,7781995,1472
63,Chr5,1282919,1283057,1282988,138
64,Chr1,9500553,9501125,9500839,572
64,Chr1,27901431,27901627,27901529,196
64,Chr2,14715303,14716115,14715709,812
64,Chr2,15922486,15922922,15922704,436
64,Chr4,9746200,9746817,9746508,617
64,Chr4,13510822,13512245,13511534,1423
64,Chr5,2195750,2195836,2195793,86
64,Chr5,8265739,8265957,8265848,218
64,Chr5,19472487,19472593,19472540,106
65,Chr1,12166646,12166672,12166659,26
65,Chr1,20015373,20015889,20015631,516
65,Chr1,29781648,29781708,29781678,60
65,Chr2,397399,397692,397545,293
65,Chr3,767056,767548,767302,492
65,Chr3,18816266,18817068,18816667,802
65,Chr5,2389201,2390412,2389807,1211
65,Chr5,14820057,14820209,14820133,152
65,Chr5,18650596,18651068,18650832,472
65,Chr5,22643245,22644651,22643948,1406
66,Chr1,10203410,10203984,10203697,574
66,Chr1,20007617,20007619,20007618,2
66,Chr1,20590949,20591439,20591194,490
66,Chr2,746098,746199,746148,101
66,Chr2,7381026,7381037,7381032,11
66,Chr2,13014608,13014944,13014776,336
66,Chr3,1439723,1440156,1439939,433
66,Chr4,8445091,8445831,8445461,740
66,Chr5,1269236,1269309,1269272,73
66,Chr5,7341023,7341553,7341288,530
66,Chr5,25197292,25197408,25197350,116
67,Chr1,1779111,1779272,1779191,161
67,Chr1,25607055,25607569,25607312,514
67,Chr2,121330,121405,121368,75
67,Chr3,5964303,5964431,5964367,128
67,Chr3,10046558,10046715,10046636,157
67,Chr5,9375081,9375328,9375205,247
67,Chr5,21334652,21335702,21335177,1050
68,Chr1,1534298,1534321,1534310,23
68,Chr1,18895448,18895461,18895454,13
68,Chr1,24920364,24921269,24920816,905
68,Chr1,29386095,29386230,29386163,135
68,Chr2,1007543,1007797,1007670,254
68,Chr2,13768807,13769319,13769063,512
68,Chr2,17495094,17495556,17495325,462
68,Chr3,9836209,9836293,9836251,84
68,Chr3,15783016,15783705,15783360,689
68,Chr3,16849171,16849502,16849337,331
68,Chr3,22224300,22228584,22226442,4284
68,Chr5,15619863,15620746,15620305,883
68,Chr5,19684471,19684642,19684557,171
69,Chr2,11755974,11756082,11756028,108
69,Chr2,15162647,15163202,15162925,555
69,Chr2,18854553,18854635,18854594,82
69,Chr3,6560320,6567142,6563731,6822
69,Chr3,9307070,9307171,9307120,101
69,Chr3,22877548,22878179,22877864,631
69,Chr4,216176,216381,216278,205
69,Chr4,10588695,10589478,10589087,783
69,Chr5,7353401,7353866,7353633,465
7,Chr1,1238774,1238986,1238880,212
7,Chr1,11279143,11279672,11279407,529
7,Chr1,24786626,24786639,24786632,13
7,Chr1,26304791,26305233,26305012,442
7,Chr2,7064795,7064943,7064869,148
7,Chr2,14261191,14261814,14261503,623
7,Chr3,10095157,10103469,10099313,8312
7,Chr3,22170340,22170964,22170652,624
7,Chr3,22616829,22616888,22616859,59
7,Chr4,524974,525044,525009,70
7,Chr4,9066713,9066917,9066815,204
7,Chr4,18457923,18458468,18458195,545
7,Chr5,19975348,19976166,19975757,818
7,Chr5,20645890,20646139,20646014,249
70,Chr1,1178349,1178608,1178479,259
70,Chr1,12605616,12607257,12606436,1641
70,Chr2,6275286,6276427,6275856,1141
70,Chr2,19255757,19259712,19257735,3955
70,Chr3,20427258,20427872,20427565,614
70,Chr3,23355040,23355052,23355046,12
70,Chr4,10464251,10464699,10464475,448
70,Chr5,5673868,5673967,5673918,99
71,Chr1,4161562,4161602,4161582,40
71,Chr1,26360648,26361420,26361034,772
71,Chr2,9547328,9548770,9548049,1442
71,Chr2,18288029,18288109,18288069,80
71,Chr3,1825277,1825893,1825585,616
71,Chr3,21264152,21264488,21264320,336
71,Chr5,2488296,2489598,2488947,1302
71,Chr5,22828536,22828670,22828603,134
71,Chr5,24901503,24903165,24902334,1662
72,Chr1,6632320,6632795,6632558,475
72,Chr1,22881430,22882001,22881716,571
72,Chr2,16015766,16016823,16016294,1057
72,Chr3,1906701,1906920,1906811,219
72,Chr5,13909662,13913080,13911371,3418
72,Chr5,18902359,18903339,18902849,980
72,Chr5,26238392,26238856,26238624,464
73,Chr1,21541121,21541415,21541268,294
73,Chr1,26683938,26684487,26684212,549
73,Chr1,29490952,29491393,29491172,441
73,Chr2,9759315,9759631,9759473,316
73,Chr3,10346211,10346248,10346229,37
73,Chr3,17027818,17027890,17027854,72
73,Chr4,8472227,8472314,8472271,87
73,Chr5,22071745,22071836,22071791,91
74,Chr1,29771922,29772062,29771992,140
74,Chr2,16847238,16850238,16848738,3000
74,Chr3,722627,724595,723611,1968
74,Chr3,1777534,1777988,1777761,454
74,Chr3,18036121,18036710,18036415,589
74,Chr4,17463428,17463448,17463438,20
74,Chr5,1527942,1529109,1528526,1167
74,Chr5,24534724,24535056,24534890,332
74,Chr5,26768872,26769515,26769194,643
75,Chr1,606019,606297,606158,278
75,Chr1,13078838,13078968,13078903,130
75,Chr1,18128622,18129787,18129204,1165
75,Chr1,25306377,25307206,25306791,829
75,Chr1,26144969,26144998,26144983,29
75,Chr2,11526673,11526858,11526765,185
75,Chr2,16332146,16332975,16332560,829
75,Chr2,19555837,19556460,19556149,623
75,Chr3,8930056,8930280,8930168,224
75,Chr4,1144368,1144424,1144396,56
75,Chr4,7768521,7768659,7768590,138
75,Chr4,17791607,17792381,17791994,774
75,Chr5,3663772,3664351,3664062,579
75,Chr5,24747918,24748802,24748360,884
76,Chr1,2863823,2867023,2865423,3200
76,Chr1,19687940,19688034,19687987,94
76,Chr1,20949886,20950012,20949949,126
76,Chr1,27448739,27449873,27449306,1134
76,Chr2,17467369,17467602,17467485,233
76,Chr3,2818994,2818996,2818995,2
76,Chr3,9495295,9495351,9495323,56
76,Chr3,20020859,20022379,20021619,1520
76,Chr4,1328856,1328977,1328916,121
76,Chr4,8082347,8082506,8082427,159
76,Chr4,12299644,12299689,12299666,45
76,Chr5,6832134,6832292,6832213,158
76,Chr5,16523037,16524924,16523981,1887
77,Chr1,10145799,10146139,10145969,340
77,Chr1,13997983,13998351,13998167,368
77,Chr1,26514850,26515034,26514942,184
77,Chr2,7902058,7902174,7902116,116
77,Chr4,1439655,1439698,1439677,43
77,Chr4,9970468,9970900,9970684,432
77,Chr4,16149214,16153915,16151564,4701
77,Chr5,1373351,1374257,1373804,906
77,Chr5,8797487,8799898,8798693,2411
78,Chr1,4893959,4894949,4894454,990
78,Chr1,8333338,8333447,8333392,109
78,Chr1,11316088,11318040,11317064,1952
78,Chr2,6167617,6167944,6167781,327
78,Chr2,15826709,15826918,15826813,209
78,Chr3,941456,941585,941520,129
78,Chr3,10415306,10415922,10415614,616
78,Chr3,18273852,18274633,18274242,781
78,Chr4,6811268,6811382,6811325,114
78,Chr4,18297269,18302509,18299889,5240
78,Chr5,19678928,19679156,19679042,228
79,Chr1,1201049,1201325,1201187,276
79,Chr1,4513209,4513224,4513217,15
79,Chr1,11087022,11087370,11087196,348
79,Chr1,19911047,19911350,19911199,303
79,Chr1,20389997,20393054,20391525,3057
79,Chr2,1989878,1989882,1989880,4
79,Chr2,18125010,18125869,18125440,859
79,Chr4,5362064,5362459,5362262,395
79,Chr4,7377202,7377845,7377524,643
79,Chr5,3384694,3384998,3384846,304
79,Chr5,4268971,4270331,4269651,1360
79,Chr5,15437848,15438239,15438044,391
79,Chr5,23336522,23337120,23336821,598
79,Chr5,24524019,24524904,24524461,885
8,Chr1,25279133,25279364,25279249,231
8,Chr1,29757855,29758423,29758139,568
8,Chr2,8276189,8276841,8276515,652
8,Chr2,9174488,9175621,9175054,1133
8,Chr2,15631927,15632427,15632177,500
8,Chr2,16040182,16041338,16040760,1156
8,Chr3,11241624,11241831,11241728,207
8,Chr3,16773046,16773087,16773066,41
8,Chr3,18640211,18642743,18641477,2532
8,Chr4,141932,142055,141994,123
8,Chr4,6899522,6899706,6899614,184
8,Chr4,17515656,17515861,17515758,205
8,Chr5,3161563,3162522,3162043,959
8,Chr5,13660632,13660704,13660668,72
8,Chr5,21438811,21439039,21438925,228
80,Chr1,20730847,20731825,20731336,978
80,Chr1,21660122,21660158,21660140,36
80,Chr2,809132,809243,809188,111
80,Chr2,10572848,10574002,10573425,1154
80,Chr3,10664422,10664734,10664578,312
80,Chr3,20775952,20775992,20775972,40
80,Chr3,23288969,23289618,23289293,649
80,Chr4,11520649,11520955,11520802,306
80,Chr5,195626,196146,195886,520
80,Chr5,5749086,5749207,5749146,121
80,Chr5,9199164,9199404,9199284,240
80,Chr5,22556573,22557681,22557127,1108
81,Chr1,21407962,21408416,21408189,454
81,Chr1,29705527,29705586,29705557,59
81,Chr2,11108326,11108455,11108390,129
81,Chr2,18484207,18485184,18484695,977
81,Chr3,1955567,1958220,1956893,2653
81,Chr3,7786504,7787181,7786842,677
81,Chr4,1043539,1044010,1043775,471
81,Chr4,16401819,16403670,16402745,1851
81,Chr5,10646250,10646323,10646286,73
82,Chr1,1885208,1885479,1885344,271
82,Chr1,2326373,2326865,2326619,492
82,Chr1,23384768,23384863,23384816,95
82,Chr2,12775267,12775373,12775320,106
82,Chr3,10651498,10652089,10651794,591
82,Chr3,20907923,20908212,20908067,289
82,Chr4,6236912,6237119,6237016,207
82,Chr4,13857209,13857237,13857223,28
82,Chr4,16645037,16645474,16645255,437
82,Chr5,5033457,5033747,5033602,290
82,Chr5,9031549,9031750,9031649,201
82,Chr5,17053557,17053574,17053565,17
82,Chr5,26730357,26730489,26730423,132
83,Chr1,1743265,1743942,1743603,677
83,Chr1,17863728,17863778,17863753,50
83,Chr1,28365811,28366063,28365937,252
83,Chr2,7902058,7902174,7902116,116
83,Chr3,20258820,20258999,20258910,179
83,Chr4,1146837,1146995,1146916,158
83,Chr4,17855909,17857262,17856585,1353
83,Chr5,17515668,17515727,17515698,59
83,Chr5,18748283,18749435,18748859,1152
83,Chr5,26680097,26680482,26680289,385
84,Chr1,7312538,7312812,7312675,274
84,Chr1,21920433,21920453,21920443,20
84,Chr2,6817666,6817701,6817684,35
84,Chr2,14050588,14051483,14051036,895
84,Chr2,18580233,18581034,18580633,801
84,Chr3,6749790,6750609,6750200,819
84,Chr3,16227545,16230006,16228775,2461
84,Chr4,5371642,5371695,5371668,53
84,Chr4,18098149,18098410,18098279,261
84,Chr5,1375755,1376072,1375913,317
84,Chr5,8220340,8220636,8220488,296
84,Chr5,16048304,16048474,16048389,170
84,Chr5,22599233,22601633,22600433,2400
85,Chr1,2993007,2993246,2993127,239
85,Chr1,7249846,7250893,7250370,1047
85,Chr1,11718906,11719081,11718994,175
85,Chr2,9921789,9921801,9921795,12
85,Chr2,10328633,10329334,10328983,701
85,Chr2,18531564,18532242,18531903,678
85,Chr3,19476163,19476752,19476457,589
85,Chr4,7791722,7791782,7791752,60
85,Chr4,18049593,18049925,18049759,332
85,Chr5,22894696,22896550,22895623,1854
85,Chr5,24216069,24216252,24216161,183
86,Chr1,9835417,9836023,9835720,606
86,Chr1,13081071,13081122,13081097,51
86,Chr1,29234220,29234249,29234234,29
86,Chr2,12628859,12629582,12629221,723
86,Chr2,17379769,17380709,17380239,940
86,Chr3,1587153,1588190,1587671,1037
86,Chr3,8108472,8109014,8108743,542
86,Chr3,19040216,19041035,19040626,819
86,Chr4,1480596,1480608,1480602,12
86,Chr4,15108796,15109231,15109014,435
86,Chr4,17084271,17085228,17084749,957
86,Chr4,17486207,17486729,17486468,522
86,Chr5,800617,800866,800741,249
86,Chr5,4645846,4647184,4646515,1338
86,Chr5,7353866,7355778,7354822,1912
86,Chr5,19397570,19398217,19397894,647
87,Chr1,4265867,4266002,4265935,135
87,Chr1,8103613,8103985,8103799,372
87,Chr1,12222499,12224729,12223614,2230
87,Chr1,21151315,21151494,21151405,179
87,Chr2,162251,162341,162296,90
87,Chr2,2308143,2309063,2308603,920
87,Chr2,13857166,13857288,13857227,122
87,Chr2,16496019,16497002,16496511,983
87,Chr3,2288121,2288208,2288165,87
87,Chr3,18480774,18481138,18480956,364
87,Chr3,19997906,19998516,19998211,610
87,Chr4,1237325,1237678,1237501,353
87,Chr5,9155104,9155407,9155256,303
87,Chr5,20006923,20007503,20007213,580
88,Chr1,6619805,6619970,6619887,165
88,Chr1,11266186,11267074,11266630,888
88,Chr1,12644815,12645082,12644949,267
88,Chr2,6742221,6742588,6742405,367
88,Chr2,9759961,9760214,9760087,253
88,Chr2,16705075,16705595,16705335,520
88,Chr3,7710973,7711407,7711190,434
88,Chr4,1515473,1515782,1515627,309
88,Chr4,6191743,6192115,6191929,372
88,Chr4,11552896,11553237,11553066,341
88,Chr4,17365718,17368231,17366974,2513
88,Chr5,3841919,3842485,3842202,566
88,Chr5,6829954,6830571,6830262,617
88,Chr5,26731341,26732475,26731908,1134
89,Chr1,6588170,6588277,6588224,107
89,Chr1,26045198,26045232,26045215,34
89,Chr2,15377532,15378644,15378088,1112
89,Chr3,3948039,3948135,3948087,96
89,Chr3,19167641,19167858,19167749,217
89,Chr4,5641354,5641839,5641596,485
89,Chr5,17535196,17535945,17535570,749
9,Chr1,469655,473429,471542,3774
9,Chr1,24713031,24713277,24713154,246
9,Chr1,26479150,26479186,26479168,36
9,Chr2,7603301,7603914,7603607,613
9,Chr2,15192193,15192571,15192382,378
9,Chr2,18631288,18631711,18631500,423
9,Chr3,3659291,3661889,3660590,2598
9,Chr3,11098081,11098162,11098121,81
9,Chr3,17550449,17551986,17551217,1537
9,Chr4,11987179,11995038,11991109,7859
9,Chr4,14893491,14893668,14893579,177
9,Chr5,22766936,22767369,22767152,433
90,Chr1,7405172,7405712,7405442,540
90,Chr1,17323701,17323705,17323703,4
90,Chr1,19832346,19832430,19832388,84
90,Chr2,6801071,6801370,6801221,299
90,Chr3,5423976,5424189,5424082,213
90,Chr4,10131166,10131605,10131386,439
90,Chr4,12699347,12700078,12699713,731
90,Chr5,16328014,16331706,16329860,3692
91,Chr1,7530684,7531127,7530906,443
91,Chr1,12734970,12735071,12735020,101
91,Chr1,23459647,23459762,23459705,115
91,Chr1,27265985,27266833,27266409,848
91,Chr2,849988,850424,850206,436
91,Chr2,1722744,1723725,1723234,981
91,Chr2,7414441,7414648,7414545,207
91,Chr2,17638313,17640031,17639172,1718
91,Chr3,5992902,5993315,5993108,413
91,Chr3,16021532,16021538,16021535,6
91,Chr4,8414267,8414357,8414312,90
91,Chr4,9646203,9646288,9646245,85
91,Chr5,3510081,3511063,3510572,982
91,Chr5,4911623,4913335,4912479,1712
91,Chr5,8024073,8024463,8024268,390
92,Chr1,772034,772303,772168,269
92,Chr1,11797312,11797371,11797342,59
92,Chr1,19589729,19589843,19589786,114
92,Chr1,23267120,23267123,23267122,3
92,Chr2,7253726,7253843,7253784,117
92,Chr2,16269247,16270043,16269645,796
92,Chr3,1142354,1142842,1142598,488
92,Chr3,10526697,10528019,10527358,1322
92,Chr3,20718152,20718992,20718572,840
92,Chr4,756806,757001,756904,195
92,Chr4,9931630,9931957,9931794,327
92,Chr5,217380,220574,218977,3194
92,Chr5,4620986,4621420,4621203,434
92,Chr5,14282057,14282215,14282136,158
92,Chr5,16148700,16149285,16148992,585
92,Chr5,23007198,23008279,23007738,1081
93,Chr1,4690603,4694570,4692587,3967
93,Chr1,6376812,6377225,6377018,413
93,Chr1,8975583,8975704,8975643,121
93,Chr1,9391451,9392614,9392033,1163
93,Chr1,30275837,30276891,30276364,1054
93,Chr2,11124754,11125185,11124970,431
93,Chr2,18305382,18305615,18305498,233
93,Chr3,10772140,10772633,10772386,493
93,Chr3,17558414,17558484,17558449,70
93,Chr4,8856178,8856384,8856281,206
93,Chr4,14310887,14311584,14311235,697
93,Chr5,2341644,2341813,2341728,169
93,Chr5,3477483,3477652,3477567,169
93,Chr5,17905354,17906056,17905705,702
93,Chr5,24233978,24236779,24235378,2801
94,Chr2,8992568,8993074,8992821,506
94,Chr3,3679887,3680933,3680410,1046
94,Chr4,6204411,6204442,6204427,31
94,Chr4,10752203,10752433,10752318,230
94,Chr5,6987225,6987702,6987463,477
94,Chr5,21914046,21914194,21914120,148
95,Chr1,847535,850465,849000,2930
95,Chr1,24699108,24699343,24699226,235
95,Chr2,17648756,17649510,17649133,754
95,Chr3,1224884,1224954,1224919,70
95,Chr3,6807835,6808680,6808257,845
95,Chr3,20374019,20374474,20374247,455
95,Chr4,8985595,8985839,8985717,244
95,Chr4,16654731,16655456,16655093,725
95,Chr5,5802427,5803051,5802739,624
96,Chr1,3453547,3454021,3453784,474
96,Chr1,10157549,10157677,10157613,128
96,Chr1,23089097,23089466,23089281,369
96,Chr1,27994683,27994931,27994807,248
96,Chr2,10850192,10850820,10850506,628
96,Chr2,18272237,18272486,18272361,249
96,Chr3,16785308,16785405,16785356,97
96,Chr3,22393270,22393470,22393370,200
96,Chr4,16286170,16286522,16286346,352
96,Chr5,6412922,6413015,6412968,93
96,Chr5,21387806,21388084,21387945,278
