lib,chrs,start,stop,cos,width
1,Chr1,26520424,26522452,26521438,2028
1,Chr2,10666721,10666964,10666843,243
1,Chr3,16890103,16890436,16890269,333
1,Chr4,8220270,8220913,8220592,643
1,Chr4,17432701,17432997,17432849,296
1,Chr5,765472,765618,765545,146
1,Chr5,8739242,8739364,8739303,122
1,Chr5,18344397,18345117,18344757,720
1,Chr5,22174890,22175344,22175117,454
1,Chr5,26253787,26253943,26253865,156
2,Chr1,3934449,3938146,3936297,3697
2,Chr2,494756,495253,495004,497
2,Chr2,6209310,6210161,6209736,851
2,Chr3,15926030,15926090,15926060,60
2,Chr5,5995013,5995980,5995497,967
3,Chr1,2353866,2354165,2354016,299
3,Chr1,15985608,15985772,15985690,164
3,Chr1,29199476,29200794,29200135,1318
3,Chr2,289413,289609,289511,196
3,Chr3,8816401,8816404,8816403,3
3,Chr4,6096042,6096802,6096422,760
3,Chr5,8042701,8042919,8042810,218
4,Chr1,11472652,11472778,11472715,126
4,Chr2,8295598,8298150,8296874,2552
4,Chr2,16786973,16788136,16787555,1163
4,Chr3,2573823,2574560,2574191,737
4,Chr4,6363632,6363826,6363729,194
4,Chr5,22828536,22828670,22828603,134
4,Chr5,26184240,26184869,26184554,629
5,Chr1,6620076,6621019,6620548,943
5,Chr1,17975588,17975935,17975762,347
5,Chr1,19473949,19474593,19474271,644
5,Chr1,28546570,28549547,28548058,2977
5,Chr2,1861232,1862055,1861644,823
5,Chr2,10509433,10509563,10509498,130
5,Chr3,1508190,1509001,1508596,811
5,Chr3,18476657,18477141,18476899,484
5,Chr4,5793003,5794456,5793729,1453
5,Chr4,8921003,8922529,8921766,1526
5,Chr5,7752565,7752619,7752592,54
5,Chr5,24375173,24375644,24375409,471
6,Chr1,3016934,3018133,3017534,1199
6,Chr1,3773865,3773964,3773915,99
6,Chr1,26686847,26687275,26687061,428
6,Chr1,28208094,28208679,28208386,585
6,Chr2,9985790,9986088,9985939,298
6,Chr2,10802444,10802453,10802448,9
6,Chr2,19488888,19489551,19489220,663
6,Chr3,953374,954306,953840,932
6,Chr3,22421890,22424707,22423298,2817
6,Chr4,80192,80682,80437,490
6,Chr4,11648275,11649257,11648766,982
6,Chr5,21064697,21066886,21065791,2189
6,Chr5,25180333,25181122,25180727,789
7,Chr1,1071783,1072172,1071977,389
7,Chr1,23354349,23354406,23354377,57
7,Chr2,1254831,1254841,1254836,10
7,Chr2,1555928,1556205,1556066,277
7,Chr3,3197029,3197798,3197413,769
7,Chr3,8711843,8712101,8711972,258
7,Chr3,17089222,17089316,17089269,94
7,Chr4,267889,268329,268109,440
7,Chr5,7382774,7383587,7383180,813
7,Chr5,14987207,14989268,14988237,2061
7,Chr5,21471847,21472066,21471957,219
8,Chr1,8075973,8076201,8076087,228
8,Chr3,11156689,11157106,11156897,417
8,Chr4,17731252,17733478,17732365,2226
8,Chr5,9852803,9853464,9853133,661
9,Chr1,17867007,17867406,17867207,399
9,Chr1,28356205,28356313,28356259,108
9,Chr4,6015897,6021350,6018623,5453
10,Chr1,28918510,28919006,28918758,496
10,Chr2,19261847,19263042,19262445,1195
10,Chr3,11802981,11803118,11803049,137
10,Chr5,1564133,1564177,1564155,44
10,Chr5,10148720,10148947,10148834,227
11,Chr1,9956555,9956636,9956595,81
11,Chr1,20493296,20496195,20494746,2899
11,Chr1,29422171,29422753,29422462,582
11,Chr2,6856798,6856976,6856887,178
11,Chr3,10772633,10777435,10775034,4802
11,Chr3,23256677,23257930,23257303,1253
11,Chr4,697260,713314,705287,16054
11,Chr4,6821435,6822620,6822027,1185
11,Chr4,11490440,11491597,11491018,1157
11,Chr5,22073660,22074132,22073896,472
12,Chr1,18324036,18327124,18325580,3088
12,Chr1,28211477,28211885,28211681,408
12,Chr2,617852,618345,618098,493
12,Chr2,19101619,19103091,19102355,1472
12,Chr4,12078877,12079268,12079073,391
12,Chr5,829021,829082,829051,61
12,Chr5,8458652,8458729,8458690,77
12,Chr5,25238539,25239365,25238952,826
13,Chr1,7014014,7014367,7014190,353
13,Chr1,16891348,16891973,16891660,625
13,Chr1,19331630,19331820,19331725,190
13,Chr2,486187,486916,486551,729
13,Chr3,4789502,4789650,4789576,148
13,Chr3,10190276,10190449,10190362,173
13,Chr4,6514126,6514184,6514155,58
13,Chr5,9516644,9517427,9517036,783
13,Chr5,18211633,18212536,18212085,903
14,Chr1,4120891,4121964,4121427,1073
14,Chr1,16133417,16133722,16133569,305
14,Chr2,6926581,6927055,6926818,474
14,Chr3,8548708,8549273,8548990,565
14,Chr3,18343631,18343815,18343723,184
14,Chr5,10932758,10933011,10932884,253
15,Chr1,8863343,8863706,8863525,363
15,Chr1,16779813,16780165,16779989,352
15,Chr2,7753412,7753532,7753472,120
15,Chr2,19319049,19320501,19319775,1452
15,Chr3,7617940,7618063,7618002,123
15,Chr4,621475,623123,622299,1648
15,Chr5,13775150,13775267,13775208,117
15,Chr5,17738043,17738283,17738163,240
16,Chr1,2439590,2441778,2440684,2188
16,Chr1,23286680,23287397,23287038,717
16,Chr2,4806175,4806437,4806306,262
16,Chr3,7751524,7754506,7753015,2982
16,Chr3,10845819,10846116,10845967,297
16,Chr5,7269200,7269581,7269390,381
16,Chr5,8020330,8021317,8020824,987
16,Chr5,22045727,22047246,22046487,1519
17,Chr1,10486260,10486761,10486510,501
17,Chr2,12297616,12298857,12298236,1241
17,Chr3,12773875,12773975,12773925,100
17,Chr4,956389,958927,957658,2538
17,Chr5,5457767,5458009,5457888,242
17,Chr5,7526437,7526492,7526465,55
17,Chr5,25445518,25447525,25446522,2007
18,Chr1,12455551,12455859,12455705,308
18,Chr1,13076724,13076966,13076845,242
18,Chr2,10170007,10171678,10170843,1671
18,Chr3,21896920,21897479,21897200,559
18,Chr4,11314377,11314822,11314599,445
18,Chr4,14865120,14865122,14865121,2
18,Chr5,1269487,1269796,1269641,309
18,Chr5,8791182,8791949,8791566,767
18,Chr5,16041584,16043668,16042626,2084
18,Chr5,18985758,18985768,18985763,10
18,Chr5,25997568,25997947,25997758,379
19,Chr2,2272346,2272947,2272646,601
19,Chr2,6827509,6833173,6830341,5664
19,Chr3,5754945,5755584,5755265,639
19,Chr3,8806344,8806602,8806473,258
19,Chr3,18944233,18944431,18944332,198
19,Chr4,9370917,9371459,9371188,542
19,Chr5,15015232,15016372,15015802,1140
19,Chr5,24116037,24116220,24116129,183
20,Chr1,18031216,18032545,18031880,1329
20,Chr2,10373681,10374485,10374083,804
20,Chr3,7942431,7943986,7943209,1555
20,Chr3,22367461,22368240,22367851,779
20,Chr4,8139008,8139627,8139318,619
20,Chr4,10649216,10650193,10649704,977
20,Chr4,12933896,12934260,12934078,364
20,Chr5,4871236,4872647,4871942,1411
20,Chr5,23239465,23239718,23239591,253
21,Chr1,5139089,5139404,5139247,315
21,Chr2,8852962,8853707,8853334,745
21,Chr3,6488550,6488999,6488774,449
21,Chr3,16802403,16802468,16802435,65
21,Chr3,18200800,18201289,18201044,489
21,Chr4,1255045,1255081,1255063,36
21,Chr5,1378619,1379059,1378839,440
21,Chr5,15999183,15999439,15999311,256
21,Chr5,22768073,22768255,22768164,182
21,Chr5,25444755,25445516,25445135,761
22,Chr1,27766254,27766881,27766568,627
22,Chr2,12940503,12942221,12941362,1718
22,Chr3,10062822,10065217,10064020,2395
22,Chr3,16568950,16569115,16569032,165
22,Chr4,9377030,9377296,9377163,266
22,Chr5,9863012,9863430,9863221,418
22,Chr5,26242639,26242737,26242688,98
23,Chr1,834962,844413,839688,9451
23,Chr1,4752467,4753060,4752763,593
23,Chr1,16874181,16874585,16874383,404
23,Chr1,24358555,24359056,24358805,501
23,Chr1,27223621,27223888,27223755,267
23,Chr2,19477725,19477947,19477836,222
23,Chr3,18451993,18452909,18452451,916
23,Chr3,22667035,22669429,22668232,2394
23,Chr4,4625532,4625595,4625564,63
23,Chr4,15515190,15515741,15515466,551
23,Chr5,1087113,1088147,1087630,1034
23,Chr5,23054743,23056181,23055462,1438
24,Chr1,17296755,17296946,17296851,191
24,Chr2,9667435,9667555,9667495,120
24,Chr2,10147894,10148450,10148172,556
24,Chr3,4444826,4452589,4448708,7763
24,Chr3,11715254,11715331,11715292,77
24,Chr5,5434734,5435678,5435206,944
24,Chr5,26686171,26686630,26686401,459
25,Chr1,12689105,12689440,12689273,335
25,Chr1,24404657,24404920,24404789,263
25,Chr3,4778277,4778489,4778383,212
25,Chr3,11523980,11524278,11524129,298
25,Chr4,11134091,11134540,11134315,449
25,Chr5,17732190,17733426,17732808,1236
26,Chr1,11025233,11026032,11025633,799
26,Chr1,26185757,26186959,26186358,1202
26,Chr2,8580568,8581423,8580996,855
26,Chr2,11862567,11862745,11862656,178
26,Chr2,15680527,15684946,15682737,4419
26,Chr3,9337563,9337655,9337609,92
26,Chr4,6255241,6255594,6255417,353
26,Chr5,8229734,8231040,8230387,1306
26,Chr5,22842949,22843054,22843001,105
27,Chr2,7125584,7132244,7128914,6660
27,Chr2,18957949,18958146,18958047,197
27,Chr3,10952335,10952428,10952381,93
27,Chr3,18750187,18750384,18750285,197
27,Chr3,22983761,22983802,22983781,41
27,Chr4,5633616,5633733,5633674,117
27,Chr4,17547237,17547652,17547445,415
27,Chr5,15870699,15871676,15871187,977
28,Chr2,9214877,9215342,9215109,465
28,Chr3,7867266,7868437,7867852,1171
28,Chr4,8294360,8296650,8295505,2290
28,Chr5,15706328,15706345,15706336,17
29,Chr1,10057433,10057773,10057603,340
29,Chr1,19319437,19319518,19319477,81
29,Chr2,1689699,1693043,1691371,3344
29,Chr2,10713748,10718141,10715944,4393
29,Chr3,7934632,7934882,7934757,250
29,Chr3,11085472,11087101,11086286,1629
29,Chr3,18576751,18577156,18576953,405
29,Chr4,11550901,11552896,11551899,1995
29,Chr5,17753861,17754000,17753931,139
30,Chr1,12635051,12635206,12635129,155
30,Chr1,26624994,26625055,26625024,61
30,Chr3,5500765,5503351,5502058,2586
30,Chr3,15706270,15706462,15706366,192
30,Chr4,6821221,6821435,6821328,214
30,Chr4,7353918,7354712,7354315,794
30,Chr4,17679721,17681437,17680579,1716
30,Chr5,21147268,21147349,21147308,81
31,Chr1,1211716,1211865,1211790,149
31,Chr1,10674617,10677698,10676157,3081
31,Chr2,9734923,9734970,9734947,47
31,Chr3,9835545,9835621,9835583,76
31,Chr3,22776659,22777266,22776963,607
31,Chr4,11020432,11020474,11020453,42
31,Chr5,5442161,5443844,5443003,1683
31,Chr5,9717038,9717917,9717478,879
31,Chr5,16088845,16088889,16088867,44
31,Chr5,23344833,23345329,23345081,496
31,Chr5,25748807,25749012,25748909,205
32,Chr1,10822294,10822621,10822458,327
32,Chr2,12375316,12375594,12375455,278
32,Chr3,7342125,7342642,7342383,517
32,Chr5,2656396,2656477,2656436,81
32,Chr5,5031501,5031656,5031579,155
32,Chr5,15379025,15379638,15379331,613
33,Chr1,23083632,23083702,23083667,70
33,Chr2,1605919,1606214,1606067,295
33,Chr2,2893347,2893987,2893667,640
33,Chr3,9339210,9339218,9339214,8
33,Chr3,15674831,15674945,15674888,114
33,Chr4,16680422,16680931,16680676,509
33,Chr5,19112596,19113161,19112878,565
33,Chr5,26702686,26702777,26702732,91
34,Chr1,4212883,4213951,4213417,1068
34,Chr1,16797891,16798509,16798200,618
34,Chr2,7365302,7365632,7365467,330
34,Chr2,9703153,9703619,9703386,466
34,Chr3,15338117,15338320,15338219,203
34,Chr3,16111644,16111761,16111702,117
34,Chr4,9986360,9986592,9986476,232
34,Chr4,17229053,17229166,17229109,113
34,Chr5,21426099,21426351,21426225,252
34,Chr5,23054743,23056181,23055462,1438
35,Chr1,568766,569173,568970,407
35,Chr2,1660026,1661964,1660995,1938
35,Chr2,17741640,17742758,17742199,1118
35,Chr3,549625,554683,552154,5058
35,Chr3,11728018,11731113,11729566,3095
35,Chr3,18481784,18482531,18482158,747
35,Chr4,5835200,5835480,5835340,280
35,Chr4,7035214,7035471,7035342,257
36,Chr2,9991665,9991911,9991788,246
36,Chr4,1393501,1396108,1394805,2607
36,Chr4,8019051,8019090,8019071,39
36,Chr5,9870167,9870202,9870185,35
36,Chr5,20149381,20186431,20167906,37050
37,Chr1,11390268,11390422,11390345,154
37,Chr1,17915333,17916654,17915993,1321
37,Chr1,19963201,19963286,19963243,85
37,Chr1,24612972,24613274,24613123,302
37,Chr2,1186486,1187377,1186932,891
37,Chr3,1312221,1312558,1312389,337
37,Chr3,1793239,1793520,1793379,281
37,Chr3,10706050,10706308,10706179,258
37,Chr5,6978777,6980058,6979417,1281
37,Chr5,7634212,7636425,7635318,2213
37,Chr5,25738544,25738960,25738752,416
38,Chr1,8005910,8006233,8006072,323
38,Chr1,12455970,12456196,12456083,226
38,Chr1,29516254,29516306,29516280,52
38,Chr3,16912799,16913128,16912963,329
38,Chr4,5711913,5712279,5712096,366
38,Chr4,7965459,7966264,7965861,805
38,Chr5,23612131,23612482,23612307,351
39,Chr2,9667370,9667435,9667402,65
39,Chr4,7528458,7528533,7528496,75
39,Chr5,16412523,16412667,16412595,144
40,Chr1,13993223,13998351,13995787,5128
40,Chr1,17766653,17768126,17767389,1473
40,Chr2,2244093,2244197,2244145,104
40,Chr2,12915996,12918383,12917190,2387
40,Chr3,11510414,11510542,11510478,128
40,Chr5,446495,447044,446769,549
40,Chr5,2453007,2453432,2453219,425
40,Chr5,16999350,16999774,16999562,424
41,Chr1,2443897,2444859,2444378,962
41,Chr1,22619688,22627671,22623680,7983
41,Chr2,1868425,1868671,1868548,246
41,Chr4,6093544,6093659,6093602,115
41,Chr5,15711972,15713194,15712583,1222
42,Chr1,20449800,20456719,20453260,6919
42,Chr2,11669003,11671747,11670375,2744
42,Chr3,18395832,18396211,18396022,379
42,Chr5,2292671,2292886,2292779,215
42,Chr5,9650578,9650630,9650604,52
43,Chr1,6641514,6642102,6641808,588
43,Chr1,17330433,17330642,17330537,209
43,Chr2,18216876,18228405,18222640,11529
43,Chr3,11746681,11748041,11747361,1360
43,Chr4,5729510,5729692,5729601,182
44,Chr1,5054681,5070376,5062529,15695
44,Chr1,5649599,5651476,5650537,1877
44,Chr1,19557024,19557202,19557113,178
44,Chr2,560385,560680,560533,295
44,Chr2,16455508,16455590,16455549,82
44,Chr3,16431598,16434127,16432862,2529
44,Chr3,16446799,16446979,16446889,180
44,Chr4,17705572,17706591,17706082,1019
45,Chr1,7403270,7403377,7403324,107
45,Chr2,6810431,6810531,6810481,100
45,Chr2,19598321,19599050,19598685,729
45,Chr3,17414029,17419850,17416939,5821
45,Chr3,17589202,17590139,17589670,937
45,Chr4,7432611,7433442,7433027,831
45,Chr4,14835576,14838555,14837066,2979
45,Chr5,9913592,9913838,9913715,246
45,Chr5,18940599,18940775,18940687,176
46,Chr1,10209778,10211457,10210618,1679
46,Chr1,29448372,29448953,29448662,581
46,Chr2,9814827,9816280,9815553,1453
46,Chr3,7631894,7632064,7631979,170
46,Chr3,8777075,8777541,8777308,466
46,Chr3,9979230,9979407,9979318,177
47,Chr1,11061304,11062278,11061791,974
47,Chr2,10859675,10861465,10860570,1790
47,Chr5,9648541,9648922,9648731,381
48,Chr2,11140052,11140374,11140213,322
48,Chr2,18651261,18656755,18654008,5494
48,Chr3,8589874,8590092,8589983,218
48,Chr3,10603537,10604382,10603959,845
48,Chr3,22920458,22922075,22921266,1617
48,Chr4,18206405,18208163,18207284,1758
49,Chr1,16309129,16309174,16309151,45
49,Chr1,19043119,19043546,19043333,427
49,Chr4,9361126,9361649,9361388,523
49,Chr5,7232290,7232417,7232354,127
49,Chr5,15775826,15775883,15775854,57
50,Chr1,12614307,12614392,12614349,85
50,Chr1,22195685,22197232,22196459,1547
50,Chr2,15965087,15965195,15965141,108
50,Chr3,14940974,14941588,14941281,614
50,Chr4,5440117,5440694,5440405,577
50,Chr4,9965385,9966023,9965704,638
50,Chr5,7387032,7387125,7387078,93
51,Chr1,604664,605176,604920,512
51,Chr1,26078287,26078886,26078587,599
51,Chr3,9212374,9213039,9212706,665
51,Chr3,20773786,20774180,20773983,394
51,Chr4,188189,188224,188207,35
51,Chr4,10589770,10589924,10589847,154
51,Chr4,16661600,16661954,16661777,354
52,Chr1,9726474,9727131,9726802,657
52,Chr2,476472,476592,476532,120
52,Chr2,16472661,16473054,16472857,393
52,Chr3,873611,873627,873619,16
52,Chr3,19287944,19291306,19289625,3362
52,Chr4,17802729,17802898,17802813,169
52,Chr5,14753349,14753403,14753376,54
52,Chr5,15467325,15467436,15467381,111
53,Chr1,7738102,7739748,7738925,1646
53,Chr3,9307171,9307286,9307229,115
53,Chr4,10723603,10724124,10723863,521
53,Chr4,12072303,12073672,12072987,1369
53,Chr5,4151099,4151852,4151475,753
53,Chr5,10136473,10136659,10136566,186
53,Chr5,21137758,21138496,21138127,738
53,Chr5,23054743,23056181,23055462,1438
54,Chr1,11665900,11666425,11666162,525
54,Chr2,13394927,13395609,13395268,682
54,Chr2,19079316,19079329,19079322,13
54,Chr3,591006,594003,592504,2997
54,Chr3,22776659,22777266,22776963,607
54,Chr4,947498,947845,947672,347
54,Chr4,9157699,9158439,9158069,740
54,Chr4,13969925,13970032,13969979,107
54,Chr5,15754608,15754941,15754774,333
54,Chr5,21265346,21265694,21265520,348
54,Chr5,26574862,26576668,26575765,1806
55,Chr1,4080799,4080900,4080849,101
55,Chr1,4874819,4875390,4875105,571
55,Chr1,17273752,17274085,17273918,333
55,Chr2,18579667,18580233,18579950,566
55,Chr3,10382180,10383352,10382766,1172
55,Chr3,18962313,18962869,18962591,556
55,Chr4,7141374,7141473,7141424,99
55,Chr4,11816144,11816972,11816558,828
55,Chr5,14528402,14529776,14529089,1374
56,Chr1,560551,562860,561705,2309
56,Chr2,6669951,6670379,6670165,428
56,Chr3,16776254,16776395,16776324,141
56,Chr4,6817855,6819258,6818557,1403
57,Chr1,5825314,5825854,5825584,540
57,Chr1,10214480,10214544,10214512,64
57,Chr1,11220640,11220749,11220694,109
57,Chr1,25063148,25063200,25063174,52
57,Chr2,9518341,9520745,9519543,2404
57,Chr3,10911339,10911612,10911475,273
57,Chr4,928746,929032,928889,286
57,Chr4,16661256,16661561,16661408,305
58,Chr1,11472652,11472778,11472715,126
58,Chr1,26531838,26535133,26533486,3295
58,Chr1,26595033,26595472,26595253,439
58,Chr2,8550024,8550104,8550064,80
58,Chr2,15153981,15154598,15154289,617
58,Chr3,10494210,10502131,10498170,7921
58,Chr4,401637,402127,401882,490
58,Chr4,1080650,1080706,1080678,56
58,Chr5,2351901,2352665,2352283,764
58,Chr5,5834259,5835491,5834875,1232
58,Chr5,21117563,21117698,21117631,135
59,Chr1,16895165,16895495,16895330,330
59,Chr2,15169425,15170110,15169767,685
59,Chr3,16894325,16894669,16894497,344
59,Chr3,16951441,16951618,16951529,177
59,Chr4,12358751,12359342,12359047,591
59,Chr4,16688430,16688625,16688528,195
59,Chr4,17728871,17730098,17729485,1227
59,Chr5,8772747,8772756,8772751,9
60,Chr1,11533946,11534446,11534196,500
60,Chr1,24369016,24369221,24369118,205
60,Chr1,25906707,25907271,25906989,564
60,Chr2,9814356,9816280,9815318,1924
60,Chr2,12144970,12145130,12145050,160
60,Chr3,9020076,9021643,9020860,1567
60,Chr3,21599287,21608492,21603889,9205
60,Chr5,941176,941832,941504,656
60,Chr5,14884623,14884890,14884757,267
61,Chr2,9766160,9766517,9766338,357
61,Chr2,19161478,19162515,19161996,1037
61,Chr3,8979876,8980818,8980347,942
61,Chr3,11401060,11401482,11401271,422
61,Chr3,19429696,19430420,19430058,724
61,Chr4,1400994,1401345,1401170,351
61,Chr4,3375396,4636678,4006037,1261282
61,Chr4,11548533,11548609,11548571,76
61,Chr5,498858,498910,498884,52
62,Chr1,4585878,4585906,4585892,28
62,Chr1,10909920,10910096,10910008,176
62,Chr1,24865246,24865970,24865608,724
62,Chr1,28377191,28377312,28377251,121
62,Chr2,15114250,15115828,15115039,1578
62,Chr3,2364072,2364347,2364210,275
62,Chr3,17240209,17240738,17240473,529
62,Chr4,10370571,10370867,10370719,296
62,Chr5,9662548,9662881,9662714,333
63,Chr1,12878893,12881313,12880103,2420
63,Chr1,16416571,16416807,16416689,236
63,Chr3,5963880,5964431,5964156,551
63,Chr3,18984014,18984473,18984244,459
63,Chr4,18440151,18442698,18441425,2547
63,Chr5,3011778,3012523,3012150,745
63,Chr5,9411182,9411276,9411229,94
63,Chr5,16818567,16819462,16819015,895
64,Chr2,7090140,7091839,7090990,1699
64,Chr2,8471225,8471591,8471408,366
64,Chr4,7169554,7180241,7174898,10687
64,Chr5,7492039,7493278,7492659,1239
65,Chr3,10334820,10336386,10335603,1566
65,Chr4,7143728,7143808,7143768,80
65,Chr4,8414737,8415877,8415307,1140
65,Chr4,18328336,18332236,18330286,3900
65,Chr5,15340550,15340601,15340576,51
65,Chr5,15608978,15611905,15610442,2927
66,Chr1,17457054,17457266,17457160,212
66,Chr1,28555762,28556152,28555957,390
66,Chr2,7817967,7818231,7818099,264
66,Chr2,13614598,13615713,13615156,1115
66,Chr4,15704253,15704384,15704319,131
66,Chr5,9356501,9356748,9356625,247
66,Chr5,15860013,15860649,15860331,636
66,Chr5,25981848,25982134,25981991,286
67,Chr1,7443207,7445310,7444259,2103
67,Chr1,12481302,12485833,12483568,4531
67,Chr2,7755089,7755449,7755269,360
67,Chr3,17587194,17587605,17587400,411
67,Chr4,5725736,5725943,5725840,207
67,Chr5,91189,92174,91681,985
67,Chr5,8797215,8799898,8798557,2683
67,Chr5,20022317,20022778,20022547,461
67,Chr5,22584116,22585027,22584572,911
68,Chr1,12689631,12692777,12691204,3146
68,Chr1,19397107,19397509,19397308,402
68,Chr3,6099737,6100092,6099915,355
68,Chr4,5708809,5709348,5709079,539
68,Chr4,11629661,11629914,11629787,253
68,Chr5,14533319,14535433,14534376,2114
68,Chr5,14825148,14825165,14825156,17
68,Chr5,26177735,26179026,26178381,1291
69,Chr1,5387662,5387764,5387713,102
69,Chr1,8936541,8936911,8936726,370
69,Chr1,25699510,25699716,25699613,206
69,Chr2,16607635,16608037,16607836,402
69,Chr3,17012113,17012349,17012231,236
69,Chr4,1378592,1378722,1378657,130
69,Chr5,26762544,26763500,26763022,956
70,Chr1,24655978,24657177,24656578,1199
70,Chr2,5920848,5921219,5921034,371
70,Chr2,6895762,6897664,6896713,1902
70,Chr3,617246,617383,617314,137
70,Chr4,5151391,5151873,5151632,482
70,Chr5,14557561,14557634,14557597,73
71,Chr1,19812568,19812763,19812666,195
71,Chr1,29370369,29370790,29370579,421
71,Chr2,2322170,2322601,2322386,431
71,Chr4,16288413,16288852,16288633,439
71,Chr5,7979031,7979855,7979443,824
71,Chr5,10613480,10613509,10613494,29
71,Chr5,23983356,23983710,23983533,354
72,Chr1,28439413,28439536,28439475,123
72,Chr2,1731860,1733074,1732467,1214
72,Chr3,18709139,18709336,18709237,197
72,Chr3,20471922,20474031,20472976,2109
72,Chr4,8069268,8069801,8069534,533
72,Chr5,1669685,1669827,1669756,142
73,Chr1,605242,605448,605345,206
73,Chr1,6865155,6865472,6865313,317
73,Chr1,11631213,11633589,11632401,2376
73,Chr2,334781,335498,335139,717
73,Chr2,10285534,10285837,10285686,303
73,Chr3,11772487,11772991,11772739,504
73,Chr3,16986804,16986834,16986819,30
73,Chr4,5347018,5347138,5347078,120
74,Chr1,7889413,7890504,7889959,1091
74,Chr2,306107,306298,306203,191
74,Chr2,7048660,7048981,7048820,321
74,Chr2,19309131,19312670,19310901,3539
74,Chr3,18209239,18209657,18209448,418
74,Chr4,9343624,9343863,9343744,239
74,Chr5,26775993,26776356,26776175,363
75,Chr1,1424237,1424464,1424351,227
75,Chr1,24787449,24787584,24787517,135
75,Chr2,9610474,9610589,9610532,115
75,Chr4,7320668,7321310,7320989,642
75,Chr4,9300162,9300688,9300425,526
76,Chr1,7884994,7885250,7885122,256
76,Chr1,15990143,15990236,15990189,93
76,Chr2,2322170,2322601,2322386,431
76,Chr3,16370019,16370203,16370111,184
76,Chr4,14867838,14868494,14868166,656
76,Chr5,13557997,13558014,13558005,17
77,Chr1,25614160,25615127,25614644,967
77,Chr2,2023986,2024893,2024440,907
77,Chr2,6686374,6686537,6686456,163
77,Chr2,17146346,17146658,17146502,312
77,Chr3,5055665,5056010,5055837,345
77,Chr3,17891095,17891426,17891261,331
77,Chr4,7782731,7782801,7782766,70
77,Chr5,13772772,13774072,13773422,1300
78,Chr1,12004249,12009333,12006791,5084
78,Chr1,19894788,19896242,19895515,1454
78,Chr1,28353855,28354028,28353941,173
78,Chr3,11103051,11103253,11103152,202
78,Chr4,5160304,5161680,5160992,1376
78,Chr4,11395063,11399326,11397195,4263
78,Chr5,13832415,13832421,13832418,6
78,Chr5,20630806,20630854,20630830,48
79,Chr1,618452,623047,620750,4595
79,Chr1,6015934,6017009,6016472,1075
79,Chr1,17247294,17247480,17247387,186
79,Chr1,27335997,27336259,27336128,262
79,Chr2,5923589,5923823,5923706,234
79,Chr3,7130557,7130889,7130723,332
79,Chr3,17561795,17562633,17562214,838
80,Chr1,4233508,4233888,4233698,380
80,Chr2,16843746,16844643,16844194,897
80,Chr2,19467282,19467401,19467342,119
80,Chr3,6120063,6120307,6120185,244
80,Chr3,16583229,16583293,16583261,64
80,Chr5,2093947,2094551,2094249,604
81,Chr1,7683202,7685402,7684302,2200
81,Chr1,17392147,17393382,17392765,1235
81,Chr1,27996713,27997785,27997249,1072
81,Chr3,16966365,16966518,16966441,153
81,Chr4,4867080,4867245,4867162,165
81,Chr4,14977030,14977526,14977278,496
81,Chr5,714119,716202,715161,2083
81,Chr5,19141135,19141235,19141185,100
82,Chr1,17464201,17464286,17464243,85
82,Chr2,652203,652292,652247,89
82,Chr2,6869708,6888965,6879336,19257
82,Chr2,16604549,16605114,16604831,565
82,Chr3,2897801,2897956,2897879,155
82,Chr3,9403201,9403203,9403202,2
82,Chr3,15737778,15738051,15737914,273
82,Chr3,20735311,20738671,20736991,3360
82,Chr3,22904801,22906108,22905455,1307
82,Chr4,11714166,11714472,11714319,306
82,Chr4,17548923,17549618,17549271,695
82,Chr5,16999350,16999774,16999562,424
82,Chr5,24100648,24102094,24101371,1446
83,Chr1,109257,109312,109285,55
83,Chr1,13279150,13279216,13279183,66
83,Chr1,18223453,18223955,18223704,502
83,Chr2,1529200,1529455,1529328,255
83,Chr2,7753412,7753532,7753472,120
83,Chr3,23187707,23189021,23188364,1314
83,Chr4,6927440,6929713,6928576,2273
83,Chr4,17527160,17527412,17527286,252
84,Chr1,11061304,11062278,11061791,974
84,Chr4,5646454,5647277,5646866,823
84,Chr5,14981023,14981371,14981197,348
84,Chr5,15408897,15409641,15409269,744
85,Chr1,4647211,4647569,4647390,358
85,Chr2,9518183,9518341,9518262,158
85,Chr2,10448757,10449131,10448944,374
85,Chr3,9213128,9214646,9213887,1518
85,Chr3,15904414,15904517,15904466,103
85,Chr3,18260516,18260966,18260741,450
85,Chr4,5152040,5152139,5152090,99
85,Chr5,6998825,6999664,6999245,839
85,Chr5,16861650,16862215,16861932,565
85,Chr5,26328954,26329940,26329447,986
86,Chr1,9193208,9193409,9193308,201
86,Chr1,9896890,9897382,9897136,492
86,Chr1,23918956,23919083,23919020,127
86,Chr1,26433298,26434265,26433782,967
86,Chr2,2347785,2347934,2347859,149
86,Chr3,602266,602485,602376,219
86,Chr3,11223500,11224646,11224073,1146
86,Chr4,143460,143674,143567,214
86,Chr5,4988723,4989139,4988931,416
86,Chr5,9713163,9716705,9714934,3542
87,Chr1,16612497,16612566,16612531,69
87,Chr1,26773025,26778696,26775861,5671
87,Chr3,7631894,7632064,7631979,170
87,Chr4,8495651,8500212,8497931,4561
87,Chr5,7851893,7852801,7852347,908
87,Chr5,15120439,15120777,15120608,338
87,Chr5,19063025,19063903,19063464,878
88,Chr1,19517538,19517595,19517566,57
88,Chr2,6215530,6218007,6216768,2477
88,Chr5,14905097,14905130,14905113,33
89,Chr1,7709155,7709688,7709421,533
89,Chr1,18398774,18399170,18398972,396
89,Chr1,24535320,24535811,24535566,491
89,Chr1,28035711,28036227,28035969,516
89,Chr2,6360559,6360955,6360757,396
89,Chr4,5184809,5184810,5184809,1
89,Chr4,8816919,8821694,8819307,4775
89,Chr5,14540899,14541393,14541146,494
89,Chr5,26316581,26318393,26317487,1812
90,Chr1,22455822,22456937,22456380,1115
90,Chr2,883708,884031,883870,323
90,Chr2,11733571,11734180,11733875,609
90,Chr2,15782991,15783007,15782999,16
90,Chr3,6333025,6333552,6333289,527
90,Chr3,14953791,14953993,14953892,202
90,Chr3,17619714,17620451,17620082,737
90,Chr3,21872106,21872776,21872441,670
90,Chr4,12101651,12102109,12101880,458
90,Chr5,1951823,1952375,1952099,552
90,Chr5,13771680,13772403,13772042,723
91,Chr1,16799450,16799669,16799560,219
91,Chr1,23846627,23846647,23846637,20
91,Chr2,2322634,2322902,2322768,268
91,Chr2,10174676,10174828,10174752,152
91,Chr2,12146480,12146763,12146622,283
91,Chr4,6896589,6896915,6896752,326
91,Chr4,17301506,17301802,17301654,296
91,Chr5,1107087,1107508,1107297,421
92,Chr1,11122710,11123645,11123178,935
92,Chr1,19551820,19552354,19552087,534
92,Chr1,24478100,24480713,24479406,2613
92,Chr3,17101038,17102442,17101740,1404
92,Chr3,22650544,22650954,22650749,410
92,Chr4,7304949,7305012,7304981,63
92,Chr5,6976044,6976290,6976167,246
93,Chr1,8654516,8654700,8654608,184
93,Chr1,26425078,26425084,26425081,6
93,Chr2,369164,378561,373862,9397
93,Chr2,6236991,6237302,6237147,311
93,Chr3,10624164,10625465,10624814,1301
93,Chr3,18501701,18501815,18501758,114
93,Chr4,9254191,9254265,9254228,74
93,Chr4,18321510,18322665,18322088,1155
93,Chr5,19133978,19134392,19134185,414
93,Chr5,20269273,20271736,20270505,2463
93,Chr5,21150079,21150133,21150106,54
94,Chr1,7737796,7738102,7737949,306
94,Chr1,24844696,24845731,24845214,1035
94,Chr2,7900963,7901207,7901085,244
94,Chr2,9708633,9709134,9708883,501
94,Chr3,5424189,5424359,5424274,170
94,Chr4,5800611,5802615,5801613,2004
94,Chr4,8080513,8080629,8080571,116
94,Chr4,17820088,17820380,17820234,292
94,Chr5,8945330,8945405,8945368,75
95,Chr1,4944035,4946045,4945040,2010
95,Chr1,18230360,18230564,18230462,204
95,Chr1,19319960,19320258,19320109,298
95,Chr1,28589062,28589317,28589190,255
95,Chr2,7727253,7728151,7727702,898
95,Chr2,18187787,18192909,18190348,5122
95,Chr3,16741624,16741780,16741702,156
95,Chr3,20739247,20739742,20739495,495
95,Chr4,9391970,9392400,9392185,430
95,Chr4,17586689,17586737,17586713,48
95,Chr5,1117626,1118019,1117822,393
96,Chr1,630457,631363,630910,906
96,Chr1,17247548,17247559,17247554,11
96,Chr2,10665764,10666721,10666242,957
96,Chr3,18997831,18997894,18997863,63
96,Chr4,6833400,6834265,6833832,865
96,Chr4,16764411,16778605,16771508,14194
96,Chr5,5932976,5933278,5933127,302
96,Chr5,13471114,13471364,13471239,250
96,Chr5,26518325,26518598,26518461,273
