lib,chrs,start,stop,cos,width
1,Chr1,110059,111864,110961,1805
1,Chr1,1680572,1681145,1680858,573
1,Chr1,3522983,3523432,3523207,449
1,Chr1,4151808,4153237,4152522,1429
1,Chr1,11775089,11776253,11775671,1164
1,Chr1,16844473,16844701,16844587,228
1,Chr1,17300594,17300654,17300624,60
1,Chr1,17527909,17537384,17532647,9475
1,Chr1,27999038,28000967,28000002,1929
1,Chr1,28877269,28882651,28879960,5382
1,Chr1,29427776,29427930,29427853,154
1,Chr1,29858569,29861728,29860149,3159
1,Chr2,7638630,7639324,7638977,694
1,Chr2,8105171,8140037,8122604,34866
1,Chr2,10828323,10829334,10828829,1011
1,Chr2,11277682,11278620,11278151,938
1,Chr2,15280559,15282113,15281336,1554
1,Chr2,16492036,16492112,16492074,76
1,Chr2,19651199,19658528,19654863,7329
1,Chr3,1499876,1501115,1500496,1239
1,Chr3,6168390,6169317,6168854,927
1,Chr3,20380359,20381164,20380761,805
1,Chr3,23293363,23294146,23293755,783
1,Chr4,186173,187613,186893,1440
1,Chr4,625415,626988,626201,1573
1,Chr4,8671363,8672755,8672059,1392
1,Chr4,9242175,9243068,9242621,893
1,Chr4,10515562,10521100,10518331,5538
1,Chr4,12491741,12492564,12492153,823
1,Chr5,533716,533787,533752,71
1,Chr5,20748374,20752809,20750592,4435
1,Chr5,23119076,23144398,23131737,25322
1,Chr5,25537808,25538253,25538030,445
10,Chr1,1150961,1153526,1152243,2565
10,Chr1,1878162,1880425,1879294,2263
10,Chr1,7157751,7159600,7158675,1849
10,Chr1,17097111,17097697,17097404,586
10,Chr1,24382581,24383236,24382909,655
10,Chr1,25046362,25046783,25046572,421
10,Chr2,10263757,10264095,10263926,338
10,Chr2,12261225,12261886,12261555,661
10,Chr2,14826911,14827555,14827233,644
10,Chr2,17863782,17866971,17865376,3189
10,Chr2,19469437,19472211,19470824,2774
10,Chr3,573032,574957,573994,1925
10,Chr3,1098385,1098595,1098490,210
10,Chr3,2992291,2992675,2992483,384
10,Chr3,4468619,4470304,4469461,1685
10,Chr3,7053389,7064120,7058755,10731
10,Chr3,8524313,8524670,8524491,357
10,Chr3,15705362,15705634,15705498,272
10,Chr3,18146548,18148349,18147448,1801
10,Chr3,22913802,22914343,22914072,541
10,Chr4,1090919,1091102,1091011,183
10,Chr4,7775601,7782731,7779166,7130
10,Chr4,9256265,9261360,9258813,5095
10,Chr4,11746626,11750773,11748700,4147
10,Chr4,13651179,13652090,13651635,911
10,Chr4,18062411,18062572,18062491,161
10,Chr5,1817726,1819425,1818576,1699
10,Chr5,3295783,3297582,3296683,1799
10,Chr5,16088889,16089430,16089159,541
10,Chr5,20061622,20061836,20061729,214
10,Chr5,20916797,20916877,20916837,80
10,Chr5,21634622,21640437,21637530,5815
10,Chr5,23175151,23214138,23194645,38987
11,Chr1,2759388,2760302,2759845,914
11,Chr1,3381223,3395748,3388485,14525
11,Chr1,6640840,6641514,6641177,674
11,Chr1,7777957,7780266,7779111,2309
11,Chr1,8920715,8920819,8920767,104
11,Chr1,19007991,19043119,19025555,35128
11,Chr1,22766172,22769682,22767927,3510
11,Chr1,25891652,25892792,25892222,1140
11,Chr1,26748753,26756530,26752641,7777
11,Chr1,27669493,27672502,27670997,3009
11,Chr1,28918339,28918375,28918357,36
11,Chr2,7038124,7038612,7038368,488
11,Chr2,7994516,7994713,7994614,197
11,Chr2,9522856,9523800,9523328,944
11,Chr2,12353512,12354308,12353910,796
11,Chr2,13399023,13400888,13399955,1865
11,Chr2,14329836,14332052,14330944,2216
11,Chr2,19020006,19020654,19020330,648
11,Chr3,187418,187440,187429,22
11,Chr3,4223716,4224536,4224126,820
11,Chr3,5060112,5061066,5060589,954
11,Chr3,21626834,21629053,21627944,2219
11,Chr4,8919645,8920999,8920322,1354
11,Chr4,12070079,12071348,12070713,1269
11,Chr5,4448079,4449324,4448701,1245
11,Chr5,5546722,5559677,5553200,12955
11,Chr5,7639495,7639726,7639611,231
11,Chr5,8418522,8418589,8418556,67
11,Chr5,26687493,26687830,26687661,337
12,Chr1,2673586,2674334,2673960,748
12,Chr1,4513342,4513389,4513366,47
12,Chr1,7128282,7130033,7129158,1751
12,Chr1,7993384,7993391,7993388,7
12,Chr1,8629527,8630103,8629815,576
12,Chr1,16869025,16869517,16869271,492
12,Chr1,20414631,20418732,20416681,4101
12,Chr1,20948514,20949886,20949200,1372
12,Chr1,23328768,23329018,23328893,250
12,Chr1,25838743,25839032,25838887,289
12,Chr2,6806525,6807863,6807194,1338
12,Chr2,12939324,12940265,12939794,941
12,Chr2,13495926,13496704,13496315,778
12,Chr2,18356634,18356967,18356800,333
12,Chr3,3656591,3656877,3656734,286
12,Chr3,6740716,6741035,6740876,319
12,Chr3,9413692,9413896,9413794,204
12,Chr3,10140896,10141281,10141088,385
12,Chr3,17477186,17477321,17477254,135
12,Chr3,21703474,21704145,21703810,671
12,Chr3,23317501,23317858,23317679,357
12,Chr4,9863275,9863290,9863283,15
12,Chr4,10399964,10400371,10400168,407
12,Chr5,128042,128133,128088,91
12,Chr5,280668,280952,280810,284
12,Chr5,3047675,3047757,3047716,82
12,Chr5,3477652,3479006,3478329,1354
12,Chr5,4944539,4944735,4944637,196
12,Chr5,15831826,15831930,15831878,104
12,Chr5,16312760,16313785,16313272,1025
12,Chr5,19406643,19407122,19406883,479
12,Chr5,20149381,20186431,20167906,37050
12,Chr5,20515888,20518729,20517308,2841
12,Chr5,22883707,22884199,22883953,492
12,Chr5,24134285,24134964,24134625,679
13,Chr1,1004842,1022802,1013822,17960
13,Chr1,2495248,2497712,2496480,2464
13,Chr1,3889096,3889347,3889222,251
13,Chr1,6453788,6457198,6455493,3410
13,Chr1,8863706,8863836,8863771,130
13,Chr1,9330861,9331592,9331227,731
13,Chr1,19043119,19043546,19043333,427
13,Chr1,23404107,23404578,23404343,471
13,Chr1,25129852,25130009,25129930,157
13,Chr2,2243797,2243944,2243871,147
13,Chr2,15706732,15717866,15712299,11134
13,Chr2,18953049,18954508,18953779,1459
13,Chr3,205684,206116,205900,432
13,Chr3,5135037,5142262,5138649,7225
13,Chr3,8990732,8992642,8991687,1910
13,Chr3,17231041,17231341,17231191,300
13,Chr4,7521994,7522716,7522355,722
13,Chr4,8713486,8713960,8713723,474
13,Chr4,13209296,13213368,13211332,4072
13,Chr4,18324142,18328336,18326239,4194
13,Chr5,143111,144121,143616,1010
13,Chr5,1291147,1291888,1291517,741
13,Chr5,3480270,3480602,3480436,332
13,Chr5,4011705,4012076,4011891,371
13,Chr5,5997458,5997947,5997702,489
13,Chr5,8237977,8238099,8238038,122
13,Chr5,16612249,16613252,16612751,1003
13,Chr5,19925221,19928632,19926927,3411
13,Chr5,20991723,20992534,20992129,811
13,Chr5,22047246,22047618,22047432,372
13,Chr5,22768398,22770238,22769318,1840
13,Chr5,23014874,23016830,23015852,1956
14,Chr1,210850,266254,238552,55404
14,Chr1,2100197,2104074,2102135,3877
14,Chr1,3032303,3033756,3033029,1453
14,Chr1,6727938,6728500,6728219,562
14,Chr1,7660913,7662060,7661487,1147
14,Chr1,9391451,9392614,9392033,1163
14,Chr1,9960737,9961242,9960989,505
14,Chr1,10623329,10623455,10623392,126
14,Chr1,12145237,12145254,12145245,17
14,Chr1,17358898,17359497,17359198,599
14,Chr1,20483834,20485869,20484852,2035
14,Chr1,24578201,24578678,24578439,477
14,Chr1,26037054,26038330,26037692,1276
14,Chr1,28044577,28046973,28045775,2396
14,Chr2,7378055,7379344,7378699,1289
14,Chr2,8167394,8168512,8167953,1118
14,Chr2,10191027,10191196,10191111,169
14,Chr2,12339408,12339569,12339488,161
14,Chr2,13949119,13949323,13949221,204
14,Chr2,15256146,15257882,15257014,1736
14,Chr2,16157379,16158095,16157737,716
14,Chr2,17311215,17320860,17316037,9645
14,Chr2,18099963,18100374,18100169,411
14,Chr3,3751346,3751413,3751380,67
14,Chr3,3851329,3854392,3852861,3063
14,Chr3,5265036,5265227,5265132,191
14,Chr3,5274900,5275264,5275082,364
14,Chr3,6274007,6276158,6275083,2151
14,Chr3,8237433,8237505,8237469,72
14,Chr3,10772509,10772633,10772571,124
14,Chr3,19150775,19158051,19154413,7276
14,Chr3,19887856,19888946,19888401,1090
14,Chr3,21349616,21352347,21350982,2731
14,Chr3,21764473,21767052,21765763,2579
14,Chr4,11662090,11662279,11662184,189
14,Chr4,12172542,12172598,12172570,56
14,Chr4,12908348,12908364,12908356,16
14,Chr4,13863400,13863596,13863498,196
14,Chr4,17995857,17998829,17997343,2972
14,Chr5,33234,36968,35101,3734
14,Chr5,271872,277216,274544,5344
14,Chr5,3861076,3871424,3866250,10348
14,Chr5,6038379,6039393,6038886,1014
14,Chr5,7417572,7420714,7419143,3142
14,Chr5,8283649,8283776,8283713,127
14,Chr5,15840931,15841027,15840979,96
14,Chr5,16445876,16446109,16445992,233
14,Chr5,18997551,18997752,18997651,201
14,Chr5,21028928,21029152,21029040,224
14,Chr5,22709150,22713072,22711111,3922
15,Chr1,105064,108696,106880,3632
15,Chr1,1878162,1880425,1879294,2263
15,Chr1,2312698,2313010,2312854,312
15,Chr1,4232928,4233098,4233013,170
15,Chr1,6328544,6330126,6329335,1582
15,Chr1,7137732,7138230,7137981,498
15,Chr1,8977128,8985127,8981128,7999
15,Chr1,11861929,11865813,11863871,3884
15,Chr1,19041086,19043119,19042102,2033
15,Chr1,27178170,27180520,27179345,2350
15,Chr1,29235922,29242615,29239268,6693
15,Chr1,29870152,29870900,29870526,748
15,Chr2,7429893,7430402,7430147,509
15,Chr2,11603658,11607434,11605546,3776
15,Chr2,12430150,12430521,12430336,371
15,Chr2,14697767,14698248,14698007,481
15,Chr2,17905376,17916319,17910848,10943
15,Chr2,19661575,19664730,19663153,3155
15,Chr3,1620079,1621563,1620821,1484
15,Chr3,4951532,4957499,4954516,5967
15,Chr3,16950814,16951352,16951083,538
15,Chr3,18881775,18883823,18882799,2048
15,Chr3,20296092,20296434,20296263,342
15,Chr4,11524174,11524186,11524180,12
15,Chr4,12828850,12834018,12831434,5168
15,Chr4,15751382,15753199,15752290,1817
15,Chr4,16185238,16188331,16186784,3093
15,Chr5,19754,23126,21440,3372
15,Chr5,45012,45111,45062,99
15,Chr5,1708705,1709445,1709075,740
15,Chr5,3846022,3846459,3846240,437
15,Chr5,19861410,19861961,19861686,551
15,Chr5,20061326,20061385,20061356,59
15,Chr5,23717793,23717949,23717871,156
15,Chr5,25461636,25462183,25461910,547
15,Chr5,26797570,26799054,26798312,1484
16,Chr1,562860,563367,563114,507
16,Chr1,4105057,4106763,4105910,1706
16,Chr1,4848779,4850961,4849870,2182
16,Chr1,5830946,5832720,5831833,1774
16,Chr1,9501125,9503918,9502521,2793
16,Chr1,17931796,17938284,17935040,6488
16,Chr1,19800653,19802693,19801673,2040
16,Chr1,20231263,20235231,20233247,3968
16,Chr1,29235922,29242615,29239268,6693
16,Chr2,8277209,8281565,8279387,4356
16,Chr2,15203637,15209519,15206578,5882
16,Chr2,19639251,19643141,19641196,3890
16,Chr3,16755727,16756559,16756143,832
16,Chr3,19854833,19857095,19855964,2262
16,Chr3,20805482,20805680,20805581,198
16,Chr3,21392487,21397021,21394754,4534
16,Chr4,1242127,1242795,1242461,668
16,Chr4,6756461,6764144,6760303,7683
16,Chr4,11529760,11529974,11529867,214
16,Chr5,2686525,2686789,2686657,264
16,Chr5,3643038,3644857,3643948,1819
16,Chr5,5209387,5209977,5209682,590
16,Chr5,5694418,5694706,5694562,288
16,Chr5,6353494,6354955,6354224,1461
16,Chr5,6847192,6849315,6848254,2123
16,Chr5,14986050,14986253,14986152,203
17,Chr1,3321865,3323366,3322615,1501
17,Chr1,5939422,5943178,5941300,3756
17,Chr1,7757278,7758011,7757644,733
17,Chr1,8680003,8680041,8680022,38
17,Chr1,9835158,9835326,9835242,168
17,Chr1,17759135,17764704,17761919,5569
17,Chr1,22574981,22575106,22575043,125
17,Chr1,25276330,25277029,25276680,699
17,Chr1,28030230,28032462,28031346,2232
17,Chr1,28926323,28927946,28927135,1623
17,Chr1,29276349,29308227,29292288,31878
17,Chr2,7766588,7766672,7766630,84
17,Chr2,11326483,11326767,11326625,284
17,Chr2,12196418,12196723,12196570,305
17,Chr2,12942472,12942617,12942544,145
17,Chr2,14049264,14050588,14049926,1324
17,Chr2,17200171,17201233,17200702,1062
17,Chr2,18370469,18371800,18371135,1331
17,Chr3,4207718,4211101,4209410,3383
17,Chr3,4962656,4963078,4962867,422
17,Chr3,5807029,5812488,5809759,5459
17,Chr3,6646992,6651772,6649382,4780
17,Chr3,8583705,8583901,8583803,196
17,Chr3,18837593,18837759,18837676,166
17,Chr3,19908365,19909659,19909012,1294
17,Chr4,8388334,8389130,8388732,796
17,Chr4,13723073,13723230,13723151,157
17,Chr4,18320362,18321510,18320936,1148
17,Chr5,16594401,16594775,16594588,374
17,Chr5,17151962,17152001,17151982,39
17,Chr5,21718512,21719197,21718854,685
17,Chr5,25400016,25402489,25401252,2473
17,Chr5,25705167,25705293,25705230,126
17,Chr5,26403499,26404308,26403903,809
17,Chr5,26812678,26812894,26812786,216
18,Chr1,183808,207856,195832,24048
18,Chr1,2319381,2319866,2319623,485
18,Chr1,3404980,3406508,3405744,1528
18,Chr1,4690603,4694570,4692587,3967
18,Chr1,9087044,9092461,9089752,5417
18,Chr1,10365273,10366397,10365835,1124
18,Chr1,11472994,11473053,11473024,59
18,Chr1,21540728,21541121,21540924,393
18,Chr1,22273322,22274847,22274084,1525
18,Chr1,26577851,26578789,26578320,938
18,Chr1,28210670,28210981,28210826,311
18,Chr2,8717731,8718830,8718281,1099
18,Chr2,11733007,11734180,11733593,1173
18,Chr2,12232108,12234817,12233462,2709
18,Chr2,16424813,16426031,16425422,1218
18,Chr2,17878346,17881639,17879992,3293
18,Chr3,1022518,1023833,1023176,1315
18,Chr3,3839134,3840431,3839782,1297
18,Chr3,5222951,5228089,5225520,5138
18,Chr3,20396383,20398415,20397399,2032
18,Chr3,21790318,21791193,21790756,875
18,Chr4,1492554,1492988,1492771,434
18,Chr4,7763921,7764299,7764110,378
18,Chr4,14041728,14043715,14042722,1987
18,Chr5,16098291,16098470,16098381,179
18,Chr5,19397570,19398217,19397894,647
18,Chr5,26921767,26921819,26921793,52
19,Chr1,559506,560551,560028,1045
19,Chr1,25511836,25531005,25521420,19169
19,Chr1,29235922,29242615,29239268,6693
19,Chr2,2423746,2423828,2423787,82
19,Chr2,9840321,9840874,9840597,553
19,Chr2,12370276,12370995,12370636,719
19,Chr2,12975459,12976023,12975741,564
19,Chr2,15956038,15957226,15956632,1188
19,Chr2,16606044,16606667,16606356,623
19,Chr2,17490902,17494268,17492585,3366
19,Chr2,18586969,18588647,18587808,1678
19,Chr3,5821630,5823265,5822448,1635
19,Chr3,9286067,9286276,9286171,209
19,Chr4,5299735,5299784,5299759,49
19,Chr5,2356294,2357159,2356726,865
19,Chr5,5478875,5489164,5484019,10289
19,Chr5,8840394,8840535,8840464,141
19,Chr5,23984696,23984834,23984765,138
19,Chr5,25462183,25462777,25462480,594
19,Chr5,26680097,26680482,26680289,385
2,Chr1,2336312,2338339,2337326,2027
2,Chr1,2631084,2632794,2631939,1710
2,Chr1,6092868,6092980,6092924,112
2,Chr1,11184662,11185014,11184838,352
2,Chr1,19214461,19215047,19214754,586
2,Chr1,21978890,21979329,21979110,439
2,Chr1,24505886,24509365,24507626,3479
2,Chr1,25058820,25059096,25058958,276
2,Chr1,26286497,26288113,26287305,1616
2,Chr2,8404957,8405117,8405037,160
2,Chr2,16249428,16250607,16250018,1179
2,Chr2,17210984,17211627,17211306,643
2,Chr2,18050442,18051351,18050896,909
2,Chr3,307876,310202,309039,2326
2,Chr3,5722656,5723006,5722831,350
2,Chr3,6594241,6604125,6599183,9884
2,Chr3,10021065,10021457,10021261,392
2,Chr3,20172915,20174666,20173791,1751
2,Chr3,22427183,22428858,22428021,1675
2,Chr4,8252086,8253467,8252776,1381
2,Chr4,11500782,11502292,11501537,1510
2,Chr4,12795289,12795485,12795387,196
2,Chr4,14424738,14425066,14424902,328
2,Chr5,2245573,2246229,2245901,656
2,Chr5,6423684,6424418,6424051,734
2,Chr5,8158950,8159435,8159192,485
2,Chr5,8603904,8604646,8604275,742
2,Chr5,9300940,9301113,9301026,173
2,Chr5,9858000,9858058,9858029,58
2,Chr5,22315225,22315364,22315295,139
2,Chr5,22774802,22774872,22774837,70
2,Chr5,23836839,23837683,23837261,844
2,Chr5,25064599,25066558,25065579,1959
20,Chr1,1779272,1781121,1780196,1849
20,Chr1,3240729,3247810,3244269,7081
20,Chr1,4041654,4044777,4043216,3123
20,Chr1,4739541,4740751,4740146,1210
20,Chr1,9448345,9453140,9450743,4795
20,Chr1,10063858,10065215,10064536,1357
20,Chr1,25350013,25350084,25350049,71
20,Chr2,9274889,9275378,9275133,489
20,Chr2,10891248,10892727,10891988,1479
20,Chr2,12285519,12285825,12285672,306
20,Chr2,13808021,13808112,13808067,91
20,Chr2,16810569,16810726,16810647,157
20,Chr3,1065668,1066606,1066137,938
20,Chr3,3693833,3693909,3693871,76
20,Chr3,5841869,5842670,5842269,801
20,Chr3,6178309,6178518,6178413,209
20,Chr3,16471765,16471789,16471777,24
20,Chr3,20526547,20527530,20527039,983
20,Chr4,6913088,6913327,6913208,239
20,Chr4,9302690,9304128,9303409,1438
20,Chr4,10437130,10437496,10437313,366
20,Chr4,12830894,12834018,12832456,3124
20,Chr5,54939,55890,55415,951
20,Chr5,803849,804960,804405,1111
20,Chr5,8590309,8590472,8590391,163
20,Chr5,14841069,14842278,14841673,1209
20,Chr5,16865895,16867246,16866571,1351
20,Chr5,18388560,18388666,18388613,106
20,Chr5,24395524,24395666,24395595,142
20,Chr5,26535037,26535057,26535047,20
20,Chr5,26810276,26810543,26810410,267
21,Chr1,2812411,2815002,2813707,2591
21,Chr1,4212166,4212883,4212524,717
21,Chr1,5231026,5233149,5232088,2123
21,Chr1,8863706,8863836,8863771,130
21,Chr1,19323479,19324475,19323977,996
21,Chr1,23652846,23653178,23653012,332
21,Chr1,25531765,25539380,25535573,7615
21,Chr1,27057533,27058567,27058050,1034
21,Chr1,30241013,30241154,30241083,141
21,Chr2,756193,756251,756222,58
21,Chr2,8527231,8527580,8527405,349
21,Chr2,9249552,9250261,9249906,709
21,Chr2,12108662,12124196,12116429,15534
21,Chr2,15044382,15044669,15044526,287
21,Chr2,19190771,19191789,19191280,1018
21,Chr3,42355,42703,42529,348
21,Chr3,9901568,9902593,9902080,1025
21,Chr3,11025764,11028163,11026964,2399
21,Chr3,16821983,16823015,16822499,1032
21,Chr3,18446504,18451528,18449016,5024
21,Chr3,19417889,19418809,19418349,920
21,Chr3,21349352,21349616,21349484,264
21,Chr4,12823173,12823587,12823380,414
21,Chr5,105427,109002,107215,3575
21,Chr5,2757496,2758001,2757748,505
21,Chr5,7291802,7296856,7294329,5054
21,Chr5,19564643,19566135,19565389,1492
21,Chr5,20239156,20240595,20239876,1439
21,Chr5,20686207,20687040,20686623,833
21,Chr5,23340709,23343867,23342288,3158
21,Chr5,26875075,26875950,26875513,875
22,Chr1,1615488,1615747,1615618,259
22,Chr1,6100558,6101102,6100830,544
22,Chr1,7112430,7112534,7112482,104
22,Chr1,8109619,8111075,8110347,1456
22,Chr1,23510150,23510793,23510472,643
22,Chr1,26543742,26546977,26545360,3235
22,Chr1,27301999,27302517,27302258,518
22,Chr1,28651893,28724228,28688061,72335
22,Chr2,6793356,6795275,6794316,1919
22,Chr2,11339376,11339539,11339458,163
22,Chr2,11830087,11830894,11830491,807
22,Chr2,14283759,14284584,14284171,825
22,Chr2,14401694,14412554,14407124,10860
22,Chr2,19288564,19289054,19288809,490
22,Chr3,2912311,2912899,2912605,588
22,Chr3,3284381,3290911,3287646,6530
22,Chr3,4032695,4033177,4032936,482
22,Chr3,5993459,5995945,5994702,2486
22,Chr3,10752693,10755363,10754028,2670
22,Chr3,18406095,18409460,18407777,3365
22,Chr3,20583054,20583226,20583140,172
22,Chr3,21398339,21435092,21416715,36753
22,Chr4,7443354,7444609,7443982,1255
22,Chr4,8691575,8704079,8697827,12504
22,Chr4,12861742,12861850,12861796,108
22,Chr4,14378321,14387219,14382770,8898
22,Chr5,735033,735161,735097,128
22,Chr5,8009652,8009873,8009762,221
22,Chr5,19812896,19816684,19814790,3788
22,Chr5,25259861,25263804,25261833,3943
23,Chr1,971198,986719,978958,15521
23,Chr1,10184643,10186250,10185447,1607
23,Chr1,10273859,10274000,10273929,141
23,Chr1,20181930,20183058,20182494,1128
23,Chr1,28746408,28756009,28751208,9601
23,Chr1,29764981,29765726,29765353,745
23,Chr2,10260738,10260827,10260782,89
23,Chr2,17185955,17191648,17188801,5693
23,Chr2,17881666,17887845,17884756,6179
23,Chr3,1837291,1837739,1837515,448
23,Chr3,16783114,16783730,16783422,616
23,Chr3,18788201,18789568,18788885,1367
23,Chr3,20010951,20013684,20012317,2733
23,Chr3,22808650,22808732,22808691,82
23,Chr4,151950,151983,151966,33
23,Chr4,8491221,8491603,8491412,382
23,Chr4,14370952,14378061,14374506,7109
23,Chr5,993402,993971,993686,569
23,Chr5,2092320,2093160,2092740,840
23,Chr5,4450185,4452776,4451481,2591
23,Chr5,21751487,21763740,21757613,12253
24,Chr1,6243191,6243402,6243297,211
24,Chr1,7583772,7584873,7584322,1101
24,Chr1,9412943,9413422,9413183,479
24,Chr1,9888610,9889003,9888806,393
24,Chr1,18427069,18428287,18427678,1218
24,Chr1,19127242,19127660,19127451,418
24,Chr1,21058758,21059587,21059172,829
24,Chr1,23485906,23486305,23486106,399
24,Chr1,26657058,26657453,26657256,395
24,Chr1,27598025,27598999,27598512,974
24,Chr1,29185056,29189332,29187194,4276
24,Chr1,29656730,29659542,29658136,2812
24,Chr2,1184857,1184867,1184862,10
24,Chr2,5057406,5057607,5057506,201
24,Chr2,15562750,15562974,15562862,224
24,Chr2,19486134,19486174,19486154,40
24,Chr3,188032,190896,189464,2864
24,Chr3,3665919,3666727,3666323,808
24,Chr3,6998822,7015757,7007290,16935
24,Chr3,10089627,10089836,10089731,209
24,Chr3,10679950,10682165,10681058,2215
24,Chr3,18878763,18879513,18879138,750
24,Chr4,15861882,15862088,15861985,206
24,Chr4,16274853,16275367,16275110,514
24,Chr5,2786447,2786593,2786520,146
24,Chr5,3316374,3316587,3316480,213
24,Chr5,3830238,3836395,3833316,6157
24,Chr5,5345341,5346054,5345697,713
24,Chr5,6192438,6192498,6192468,60
24,Chr5,8003067,8003716,8003391,649
24,Chr5,13872834,13875080,13873957,2246
24,Chr5,19399322,19399447,19399384,125
24,Chr5,21365027,21365097,21365062,70
24,Chr5,21575620,21575955,21575788,335
24,Chr5,22887873,22889386,22888629,1513
24,Chr5,22923362,22923481,22923422,119
24,Chr5,24090023,24092262,24091143,2239
24,Chr5,26771427,26771746,26771587,319
25,Chr1,562860,563367,563114,507
25,Chr1,605242,605448,605345,206
25,Chr1,1221161,1221314,1221237,153
25,Chr1,11813260,11813908,11813584,648
25,Chr1,20092912,20093068,20092990,156
25,Chr1,24016745,24018041,24017393,1296
25,Chr1,24498311,24498614,24498463,303
25,Chr1,28651893,28724228,28688061,72335
25,Chr2,1640902,1640916,1640909,14
25,Chr2,16292802,16294758,16293780,1956
25,Chr2,17950237,17951178,17950707,941
25,Chr2,18924824,18928569,18926696,3745
25,Chr3,3431571,3432928,3432249,1357
25,Chr3,9037231,9037666,9037449,435
25,Chr3,16632752,16633535,16633144,783
25,Chr3,22806344,22806461,22806402,117
25,Chr4,460817,461339,461078,522
25,Chr4,13248817,13249121,13248969,304
25,Chr4,13781526,13793924,13787725,12398
25,Chr5,214236,214454,214345,218
25,Chr5,1375755,1376072,1375913,317
25,Chr5,5492096,5495139,5493618,3043
25,Chr5,6385875,6386151,6386013,276
25,Chr5,6791364,6792067,6791716,703
25,Chr5,8850257,8855729,8852993,5472
25,Chr5,10860659,10863062,10861861,2403
25,Chr5,18454696,18454910,18454803,214
25,Chr5,20873148,20874669,20873908,1521
25,Chr5,22277559,22278703,22278131,1144
25,Chr5,24768165,24768883,24768524,718
25,Chr5,24937186,24938811,24937998,1625
25,Chr5,25698391,25699212,25698801,821
25,Chr5,26014814,26015282,26015048,468
26,Chr1,3381223,3395748,3388485,14525
26,Chr1,6980681,6983550,6982115,2869
26,Chr1,8863343,8863706,8863525,363
26,Chr1,9387830,9389608,9388719,1778
26,Chr1,10957985,10962291,10960138,4306
26,Chr1,11638937,11640462,11639699,1525
26,Chr1,27403000,27404519,27403760,1519
26,Chr1,29572776,29572830,29572803,54
26,Chr2,431948,438758,435353,6810
26,Chr3,665528,666626,666077,1098
26,Chr3,1462167,1463037,1462602,870
26,Chr3,6112731,6113066,6112899,335
26,Chr3,8287228,8287594,8287411,366
26,Chr3,19266875,19267821,19267348,946
26,Chr3,20116770,20119061,20117916,2291
26,Chr3,21468762,21492444,21480603,23682
26,Chr3,23145526,23145792,23145659,266
26,Chr4,7113623,7114078,7113851,455
26,Chr4,11178053,11178577,11178315,524
26,Chr4,11797652,11797850,11797751,198
26,Chr4,13507195,13508352,13507773,1157
26,Chr4,14157872,14163219,14160546,5347
26,Chr5,336963,338007,337485,1044
26,Chr5,4665949,4666368,4666159,419
26,Chr5,13772879,13772971,13772925,92
26,Chr5,18682941,18683425,18683183,484
26,Chr5,23119076,23144398,23131737,25322
26,Chr5,23790818,23792149,23791484,1331
27,Chr1,563546,566579,565062,3033
27,Chr1,10866091,10867168,10866629,1077
27,Chr1,27533108,27533175,27533142,67
27,Chr1,29327547,29327994,29327771,447
27,Chr2,336464,336996,336730,532
27,Chr2,9233712,9234047,9233880,335
27,Chr2,10323829,10327461,10325645,3632
27,Chr2,14394414,14396346,14395380,1932
27,Chr2,14855900,14856639,14856270,739
27,Chr2,16091966,16092513,16092240,547
27,Chr2,19467282,19467401,19467342,119
27,Chr3,116833,120693,118763,3860
27,Chr3,1358065,1359868,1358967,1803
27,Chr3,2345980,2346273,2346126,293
27,Chr3,2442206,2444719,2443462,2513
27,Chr3,3073193,3075252,3074223,2059
27,Chr3,4346182,4347084,4346633,902
27,Chr3,6182739,6183381,6183060,642
27,Chr3,8086423,8086692,8086557,269
27,Chr3,18429734,18432692,18431213,2958
27,Chr3,20319042,20320090,20319566,1048
27,Chr3,21063094,21064280,21063687,1186
27,Chr4,5150583,5151385,5150984,802
27,Chr4,7268653,7269288,7268971,635
27,Chr4,7429444,7429864,7429654,420
27,Chr4,8391544,8393184,8392364,1640
27,Chr4,13793924,13816294,13805109,22370
27,Chr5,1609189,1609355,1609272,166
27,Chr5,7984257,7987792,7986025,3535
27,Chr5,18106742,18111804,18109273,5062
27,Chr5,19849748,19851249,19850498,1501
27,Chr5,22810157,22811115,22810636,958
27,Chr5,26630232,26630727,26630480,495
28,Chr1,99667,100847,100257,1180
28,Chr1,3554155,3554298,3554227,143
28,Chr1,4242344,4244326,4243335,1982
28,Chr1,4855837,4857245,4856541,1408
28,Chr1,6263817,6264967,6264392,1150
28,Chr1,6942678,6943214,6942946,536
28,Chr1,10810266,10810554,10810410,288
28,Chr1,25511836,25531005,25521420,19169
28,Chr1,27402849,27402912,27402881,63
28,Chr1,28732706,28739401,28736054,6695
28,Chr1,29560808,29561250,29561029,442
28,Chr2,8254150,8254632,8254391,482
28,Chr2,9545757,9546197,9545977,440
28,Chr2,14236945,14238397,14237671,1452
28,Chr2,16025165,16028641,16026903,3476
28,Chr2,19581566,19581632,19581599,66
28,Chr3,975698,978356,977027,2658
28,Chr3,1421399,1421525,1421462,126
28,Chr3,5613065,5613293,5613179,228
28,Chr3,19878131,19878954,19878543,823
28,Chr4,336134,336941,336538,807
28,Chr5,8970503,8981546,8976025,11043
28,Chr5,17243947,17243998,17243973,51
28,Chr5,19212487,19213050,19212769,563
28,Chr5,22100357,22116552,22108455,16195
28,Chr5,25803186,25804393,25803790,1207
28,Chr5,26904731,26906090,26905411,1359
29,Chr1,1348919,1382716,1365817,33797
29,Chr1,4064374,4065141,4064758,767
29,Chr1,7545952,7550110,7548031,4158
29,Chr1,13141717,13142460,13142089,743
29,Chr1,18872610,18872790,18872700,180
29,Chr1,20061490,20061539,20061514,49
29,Chr1,25583934,25598126,25591030,14192
29,Chr1,26259117,26259189,26259153,72
29,Chr1,28230593,28230862,28230727,269
29,Chr2,2348271,2348713,2348492,442
29,Chr2,10906463,10906702,10906583,239
29,Chr2,11564215,11564935,11564575,720
29,Chr2,19351563,19353302,19352433,1739
29,Chr3,1132298,1132789,1132544,491
29,Chr3,2211845,2214730,2213287,2885
29,Chr3,8172463,8173451,8172957,988
29,Chr3,18379254,18379789,18379522,535
29,Chr3,19579238,19579673,19579456,435
29,Chr4,881090,881234,881162,144
29,Chr4,9440737,9441085,9440911,348
29,Chr4,13588185,13612527,13600356,24342
29,Chr5,5111417,5122196,5116807,10779
29,Chr5,5674090,5674523,5674306,433
29,Chr5,23676684,23681526,23679105,4842
3,Chr1,624717,625021,624869,304
3,Chr1,5837428,5838858,5838143,1430
3,Chr1,6249320,6251079,6250200,1759
3,Chr1,10212255,10213494,10212875,1239
3,Chr1,12064317,12064402,12064359,85
3,Chr1,13052023,13054815,13053419,2792
3,Chr1,17270860,17271012,17270936,152
3,Chr1,19041086,19043119,19042102,2033
3,Chr1,25306377,25307206,25306791,829
3,Chr1,29942152,29947090,29944621,4938
3,Chr2,8185581,8188814,8187197,3233
3,Chr2,15562974,15563503,15563238,529
3,Chr2,17000589,17003052,17001821,2463
3,Chr2,17723840,17725175,17724508,1335
3,Chr2,19488888,19489551,19489220,663
3,Chr2,19606040,19606410,19606225,370
3,Chr3,2345337,2345421,2345379,84
3,Chr3,3597609,3598666,3598137,1057
3,Chr3,16920769,16920949,16920859,180
3,Chr3,21500370,21513104,21506737,12734
3,Chr4,6206136,6206396,6206266,260
3,Chr4,12851868,12852098,12851983,230
3,Chr4,13362530,13366485,13364508,3955
3,Chr4,18415187,18415607,18415397,420
3,Chr5,2494656,2495665,2495160,1009
3,Chr5,4055941,4057532,4056737,1591
3,Chr5,6441359,6442524,6441941,1165
3,Chr5,8144215,8144421,8144318,206
3,Chr5,21662157,21663981,21663069,1824
3,Chr5,23942587,23943206,23942897,619
30,Chr1,5481514,5481989,5481752,475
30,Chr1,9762102,9763866,9762984,1764
30,Chr1,11108721,11108858,11108789,137
30,Chr1,11903456,11908372,11905914,4916
30,Chr1,25782909,25783591,25783250,682
30,Chr1,26539633,26539906,26539769,273
30,Chr1,28954629,28954843,28954736,214
30,Chr2,6187358,6189501,6188430,2143
30,Chr2,7090140,7091839,7090990,1699
30,Chr2,8105171,8140037,8122604,34866
30,Chr2,11889349,11889575,11889462,226
30,Chr2,12101343,12104379,12102861,3036
30,Chr2,13032381,13032543,13032462,162
30,Chr2,13074040,13074325,13074182,285
30,Chr2,15915592,15915728,15915660,136
30,Chr2,16594148,16594679,16594414,531
30,Chr2,18142609,18145029,18143819,2420
30,Chr3,5763429,5764849,5764139,1420
30,Chr3,20001581,20002920,20002251,1339
30,Chr4,511858,511952,511905,94
30,Chr4,932431,932822,932627,391
30,Chr4,5367927,5368132,5368029,205
30,Chr4,8487098,8487302,8487200,204
30,Chr4,9668667,9669085,9668876,418
30,Chr4,10163215,10164327,10163771,1112
30,Chr4,12520145,12522116,12521131,1971
30,Chr4,13681396,13681533,13681464,137
30,Chr4,14303952,14304676,14304314,724
30,Chr5,1416381,1416554,1416467,173
30,Chr5,2861682,2864625,2863154,2943
30,Chr5,3738763,3739552,3739157,789
30,Chr5,4151896,4152021,4151958,125
30,Chr5,4665949,4666368,4666159,419
30,Chr5,16296699,16297290,16296995,591
30,Chr5,23175151,23214138,23194645,38987
30,Chr5,26001735,26004541,26003138,2806
30,Chr5,26766446,26768820,26767633,2374
30,Chr5,26862391,26862899,26862645,508
31,Chr1,162616,163492,163054,876
31,Chr1,1105667,1108301,1106984,2634
31,Chr1,1641504,1642577,1642040,1073
31,Chr1,4857245,4857771,4857508,526
31,Chr1,8966237,8967311,8966774,1074
31,Chr1,10373341,10373703,10373522,362
31,Chr1,11832563,11832624,11832593,61
31,Chr1,18915314,18915710,18915512,396
31,Chr1,20340342,20342252,20341297,1910
31,Chr1,26538046,26539906,26538976,1860
31,Chr1,28551883,28552774,28552329,891
31,Chr1,29777281,29777361,29777321,80
31,Chr2,1031226,1031845,1031536,619
31,Chr2,8763821,8763830,8763825,9
31,Chr2,12836474,12838028,12837251,1554
31,Chr2,13252795,13255722,13254259,2927
31,Chr2,15564323,15568876,15566599,4553
31,Chr2,18959587,18960901,18960244,1314
31,Chr3,2465821,2466517,2466169,696
31,Chr3,4226164,4227822,4226993,1658
31,Chr3,5708997,5709904,5709451,907
31,Chr3,6671611,6672200,6671905,589
31,Chr3,10162268,10163205,10162736,937
31,Chr3,15834177,15834708,15834443,531
31,Chr3,17797414,17798035,17797724,621
31,Chr3,19931624,19932950,19932287,1326
31,Chr3,20438126,20438445,20438286,319
31,Chr3,23022006,23022590,23022298,584
31,Chr4,12378662,12382189,12380426,3527
31,Chr5,1056110,1058110,1057110,2000
31,Chr5,5258530,5258882,5258706,352
31,Chr5,7084741,7085123,7084932,382
31,Chr5,16058429,16058522,16058475,93
31,Chr5,16795705,16795802,16795753,97
31,Chr5,22464744,22465711,22465228,967
31,Chr5,25334716,25335522,25335119,806
32,Chr1,1104250,1105328,1104789,1078
32,Chr1,2872224,2872882,2872553,658
32,Chr1,5021513,5035603,5028558,14090
32,Chr1,6638773,6640840,6639807,2067
32,Chr1,9276879,9308755,9292817,31876
32,Chr1,11179184,11180475,11179830,1291
32,Chr1,23518194,23520273,23519234,2079
32,Chr2,7513060,7513899,7513480,839
32,Chr2,9733739,9734084,9733911,345
32,Chr2,13013497,13013601,13013549,104
32,Chr2,13872931,13875833,13874382,2902
32,Chr3,65970,66420,66195,450
32,Chr3,475370,477817,476594,2447
32,Chr3,1490787,1490996,1490891,209
32,Chr3,8467290,8468073,8467682,783
32,Chr3,10890005,10890536,10890271,531
32,Chr3,23228002,23242592,23235297,14590
32,Chr4,407687,408274,407981,587
32,Chr4,5496914,5497514,5497214,600
32,Chr4,8333274,8334971,8334122,1697
32,Chr4,13086894,13091222,13089058,4328
32,Chr4,13160117,13161081,13160599,964
32,Chr4,14004563,14004892,14004727,329
32,Chr4,14436465,14437834,14437149,1369
32,Chr4,15206109,15206370,15206239,261
32,Chr4,17764171,17765200,17764685,1029
32,Chr5,619817,619877,619847,60
32,Chr5,703558,705240,704399,1682
32,Chr5,4094773,4096231,4095502,1458
32,Chr5,14550181,14550200,14550191,19
32,Chr5,15585698,15585930,15585814,232
32,Chr5,19970772,19973584,19972178,2812
33,Chr1,364128,371972,368050,7844
33,Chr1,8633670,8633825,8633748,155
33,Chr1,17831754,17832913,17832334,1159
33,Chr1,20479814,20483834,20481824,4020
33,Chr1,27951759,27952668,27952213,909
33,Chr1,29730787,29731828,29731307,1041
33,Chr2,215586,216827,216206,1241
33,Chr2,7902058,7902174,7902116,116
33,Chr2,12424259,12424612,12424435,353
33,Chr2,14537723,14537985,14537854,262
33,Chr2,15501342,15501598,15501470,256
33,Chr2,19597723,19598321,19598022,598
33,Chr3,431310,438923,435116,7613
33,Chr3,5749287,5752528,5750907,3241
33,Chr3,19226092,19230189,19228140,4097
33,Chr3,21931230,21931464,21931347,234
33,Chr3,23281939,23282555,23282247,616
33,Chr4,190806,200818,195812,10012
33,Chr4,6143976,6144409,6144192,433
33,Chr4,8387434,8387548,8387491,114
33,Chr4,9334225,9335683,9334954,1458
33,Chr4,12474273,12479400,12476837,5127
33,Chr5,3058931,3062640,3060785,3709
33,Chr5,4000867,4001466,4001167,599
33,Chr5,4433740,4435973,4434856,2233
33,Chr5,4441475,4441798,4441637,323
33,Chr5,5130626,5130837,5130732,211
33,Chr5,7950301,7952157,7951229,1856
33,Chr5,21330991,21331328,21331159,337
33,Chr5,22164189,22174106,22169147,9917
33,Chr5,23650917,23653432,23652175,2515
34,Chr1,1474515,1476636,1475575,2121
34,Chr1,2679553,2684066,2681809,4513
34,Chr1,4288731,4288845,4288788,114
34,Chr1,5001071,5005687,5003379,4616
34,Chr1,11412027,11412409,11412218,382
34,Chr1,17287683,17288068,17287875,385
34,Chr1,23582661,23584431,23583546,1770
34,Chr1,28145232,28145507,28145370,275
34,Chr1,29066463,29067148,29066805,685
34,Chr2,295317,295928,295623,611
34,Chr2,5694818,5695037,5694928,219
34,Chr2,8167394,8168512,8167953,1118
34,Chr2,9027165,9027730,9027447,565
34,Chr2,12101343,12104379,12102861,3036
34,Chr2,17848035,17848787,17848411,752
34,Chr3,3375074,3384595,3379834,9521
34,Chr3,6099737,6100092,6099915,355
34,Chr3,7932673,7932884,7932779,211
34,Chr3,10735371,10735475,10735423,104
34,Chr3,16923166,16923280,16923223,114
34,Chr3,21413314,21435092,21424203,21778
34,Chr4,6764144,6764323,6764234,179
34,Chr5,1871750,1872781,1872266,1031
34,Chr5,2456492,2456854,2456673,362
34,Chr5,7585857,7586369,7586113,512
34,Chr5,8203272,8204055,8203664,783
34,Chr5,18524719,18529788,18527253,5069
34,Chr5,20543859,20544023,20543941,164
34,Chr5,22708530,22709150,22708840,620
34,Chr5,26912269,26912386,26912327,117
35,Chr1,3938146,4027386,3982766,89240
35,Chr1,5320767,5321956,5321361,1189
35,Chr1,6978360,6980681,6979520,2321
35,Chr1,20199586,20204587,20202086,5001
35,Chr1,22915164,22917214,22916189,2050
35,Chr1,27596429,27597149,27596789,720
35,Chr1,28477388,28486451,28481920,9063
35,Chr1,28890014,28898023,28894018,8009
35,Chr1,30371373,30371778,30371575,405
35,Chr2,17200171,17201233,17200702,1062
35,Chr2,18521055,18523140,18522097,2085
35,Chr2,19020676,19044487,19032582,23811
35,Chr3,6390712,6391084,6390898,372
35,Chr3,9777894,9779901,9778898,2007
35,Chr3,17317739,17319379,17318559,1640
35,Chr3,21392487,21397021,21394754,4534
35,Chr3,22345697,22349167,22347432,3470
35,Chr4,13079190,13079557,13079374,367
35,Chr4,13723230,13764990,13744110,41760
35,Chr5,1442658,1443313,1442986,655
35,Chr5,7109164,7110926,7110045,1762
35,Chr5,9693299,9694108,9693703,809
35,Chr5,9713163,9716705,9714934,3542
35,Chr5,10860659,10863062,10861861,2403
35,Chr5,19099255,19099473,19099364,218
35,Chr5,20209182,20212202,20210692,3020
35,Chr5,20946673,20949795,20948234,3122
35,Chr5,21778390,21779715,21779052,1325
35,Chr5,22709150,22713072,22711111,3922
35,Chr5,24634720,24635917,24635318,1197
35,Chr5,26366757,26367407,26367082,650
36,Chr1,6674670,6674686,6674678,16
36,Chr1,6862189,6862320,6862255,131
36,Chr1,9871498,9876819,9874158,5321
36,Chr1,10112503,10112754,10112629,251
36,Chr1,11139634,11139725,11139680,91
36,Chr1,11828684,11829075,11828880,391
36,Chr1,18169973,18170814,18170393,841
36,Chr1,23805941,23806485,23806213,544
36,Chr1,26131055,26132410,26131733,1355
36,Chr1,27829653,27829931,27829792,278
36,Chr2,411460,411474,411467,14
36,Chr2,1124055,1124107,1124081,52
36,Chr2,7255916,7256731,7256324,815
36,Chr2,11172886,11175391,11174138,2505
36,Chr2,15990290,15990408,15990349,118
36,Chr2,19265373,19266173,19265773,800
36,Chr3,5267221,5268523,5267872,1302
36,Chr3,5933596,5934548,5934072,952
36,Chr3,7134406,7135285,7134846,879
36,Chr4,403483,404455,403969,972
36,Chr4,5797456,5800426,5798941,2970
36,Chr4,10327835,10327954,10327895,119
36,Chr5,2839059,2840553,2839806,1494
36,Chr5,3363660,3363987,3363824,327
36,Chr5,22575163,22575516,22575339,353
36,Chr5,24458800,24460091,24459446,1291
37,Chr1,151639,153232,152435,1593
37,Chr1,1953198,1953448,1953323,250
37,Chr1,2426565,2426658,2426611,93
37,Chr1,4944035,4946045,4945040,2010
37,Chr1,7290237,7290616,7290427,379
37,Chr1,9254129,9259172,9256651,5043
37,Chr1,10626595,10626896,10626745,301
37,Chr1,17703203,17705586,17704395,2383
37,Chr1,22925053,22925067,22925060,14
37,Chr1,25233692,25233746,25233719,54
37,Chr1,26476085,26476707,26476396,622
37,Chr1,28952968,28953663,28953316,695
37,Chr1,29763145,29765726,29764435,2581
37,Chr1,30383702,30385413,30384558,1711
37,Chr2,524084,524145,524114,61
37,Chr2,7106499,7107182,7106841,683
37,Chr2,13542109,13544967,13543538,2858
37,Chr2,16119069,16119667,16119368,598
37,Chr2,16198465,16200123,16199294,1658
37,Chr2,17000589,17003052,17001821,2463
37,Chr2,19260777,19261047,19260912,270
37,Chr3,812690,814118,813404,1428
37,Chr3,5766989,5767431,5767210,442
37,Chr3,9800951,9801213,9801082,262
37,Chr3,11028163,11029939,11029051,1776
37,Chr3,16935352,16935437,16935394,85
37,Chr3,17376088,17376559,17376324,471
37,Chr3,18662233,18663291,18662762,1058
37,Chr3,21142068,21142283,21142176,215
37,Chr3,22922086,22922395,22922240,309
37,Chr4,1002675,1002777,1002726,102
37,Chr4,8243633,8243857,8243745,224
37,Chr4,8297964,8298041,8298002,77
37,Chr4,10346841,10350478,10348659,3637
37,Chr4,11441319,11441782,11441551,463
37,Chr4,12915330,12916085,12915708,755
37,Chr4,13531246,13546672,13538959,15426
37,Chr4,14393164,14393453,14393308,289
37,Chr5,854996,859838,857417,4842
37,Chr5,1753947,1754033,1753990,86
37,Chr5,2831387,2838442,2834915,7055
37,Chr5,7269200,7269581,7269390,381
37,Chr5,24696098,24700114,24698106,4016
37,Chr5,26252794,26253329,26253062,535
37,Chr5,26818921,26821121,26820021,2200
38,Chr1,171664,171736,171700,72
38,Chr1,2308714,2310510,2309612,1796
38,Chr1,5509546,5510088,5509817,542
38,Chr1,6740422,6740532,6740477,110
38,Chr1,17921687,17928740,17925213,7053
38,Chr1,20424848,20426747,20425798,1899
38,Chr1,26689069,26692537,26690803,3468
38,Chr2,634631,635224,634927,593
38,Chr2,7499279,7499476,7499377,197
38,Chr2,9905382,9905405,9905394,23
38,Chr2,12264075,12266972,12265523,2897
38,Chr2,16195716,16195788,16195752,72
38,Chr2,17471736,17472127,17471932,391
38,Chr3,8241605,8242969,8242287,1364
38,Chr3,21734272,21735685,21734978,1413
38,Chr3,22145826,22146408,22146117,582
38,Chr3,22811965,22813034,22812499,1069
38,Chr3,22960009,22961028,22960519,1019
38,Chr4,9157460,9157699,9157580,239
38,Chr4,11547014,11548102,11547558,1088
38,Chr5,1417675,1417821,1417748,146
38,Chr5,1848991,1868216,1858603,19225
38,Chr5,2942234,2942542,2942388,308
38,Chr5,4042170,4042652,4042411,482
38,Chr5,5155529,5155760,5155645,231
38,Chr5,6411387,6412204,6411795,817
38,Chr5,22575163,22575516,22575339,353
38,Chr5,23081988,23085426,23083707,3438
39,Chr1,797322,834960,816141,37638
39,Chr1,1348919,1382716,1365817,33797
39,Chr1,6623447,6623991,6623719,544
39,Chr1,7780266,7781619,7780942,1353
39,Chr1,8391346,8392782,8392064,1436
39,Chr1,10851848,10851929,10851888,81
39,Chr1,19014090,19031018,19022554,16928
39,Chr1,26944906,26945699,26945302,793
39,Chr1,27627270,27628535,27627902,1265
39,Chr1,29748117,29749252,29748685,1135
39,Chr2,2308435,2309063,2308749,628
39,Chr2,7931569,7932047,7931808,478
39,Chr2,9421002,9421818,9421410,816
39,Chr2,15014143,15014426,15014285,283
39,Chr2,18142609,18145029,18143819,2420
39,Chr2,18615220,18616502,18615861,1282
39,Chr2,19086970,19088642,19087806,1672
39,Chr2,19491310,19491377,19491344,67
39,Chr3,3094073,3096059,3095066,1986
39,Chr3,4365951,4367690,4366821,1739
39,Chr3,6560320,6567142,6563731,6822
39,Chr3,7926100,7927075,7926588,975
39,Chr3,9833701,9835136,9834419,1435
39,Chr3,18707914,18708149,18708032,235
39,Chr3,21392487,21397021,21394754,4534
39,Chr4,10827744,10827968,10827856,224
39,Chr4,12826296,12827066,12826681,770
39,Chr5,1848991,1868216,1858603,19225
39,Chr5,2656477,2657663,2657070,1186
39,Chr5,3479940,3480114,3480027,174
39,Chr5,4158077,4158621,4158349,544
39,Chr5,5153146,5154846,5153996,1700
39,Chr5,9812993,9815501,9814247,2508
39,Chr5,20127631,20186431,20157031,58800
39,Chr5,24396929,24398448,24397689,1519
4,Chr1,9158156,9160724,9159440,2568
4,Chr1,25692192,25693964,25693078,1772
4,Chr2,9399135,9400002,9399569,867
4,Chr2,11480940,11481953,11481446,1013
4,Chr2,14909745,14911378,14910561,1633
4,Chr2,15867606,15869896,15868751,2290
4,Chr2,17253323,17320860,17287091,67537
4,Chr2,17807379,17807746,17807563,367
4,Chr3,591006,594003,592504,2997
4,Chr3,2310418,2312158,2311288,1740
4,Chr3,5253129,5254901,5254015,1772
4,Chr3,17792187,17792810,17792499,623
4,Chr3,17993234,17993334,17993284,100
4,Chr4,1276211,1276661,1276436,450
4,Chr4,5150380,5150583,5150482,203
4,Chr4,12865115,12865153,12865134,38
4,Chr5,2212688,2213677,2213182,989
4,Chr5,14717569,14717912,14717741,343
4,Chr5,16560058,16560278,16560168,220
4,Chr5,22001193,22001404,22001299,211
4,Chr5,25462777,25463126,25462951,349
40,Chr1,4040943,4041654,4041299,711
40,Chr1,4752467,4753060,4752763,593
40,Chr1,8550078,8551077,8550578,999
40,Chr1,9306076,9308755,9307416,2679
40,Chr1,27154590,27155211,27154900,621
40,Chr2,9552582,9555392,9553987,2810
40,Chr2,11812530,11813102,11812816,572
40,Chr2,12371273,12371378,12371325,105
40,Chr2,18556689,18559004,18557847,2315
40,Chr2,19467282,19467401,19467342,119
40,Chr3,4710381,4714761,4712571,4380
40,Chr3,20597915,20599389,20598652,1474
40,Chr3,23165361,23166249,23165805,888
40,Chr4,10973055,10973238,10973147,183
40,Chr4,12012152,12012603,12012378,451
40,Chr4,12479400,12484019,12481710,4619
40,Chr4,13298400,13299685,13299042,1285
40,Chr4,13793924,13816294,13805109,22370
40,Chr4,14502449,14503021,14502735,572
40,Chr5,5022799,5024301,5023550,1502
40,Chr5,5706894,5707071,5706982,177
40,Chr5,6671456,6671956,6671706,500
40,Chr5,15957051,15958098,15957575,1047
40,Chr5,21496191,21496489,21496340,298
40,Chr5,24318786,24318900,24318843,114
41,Chr1,7522615,7522673,7522644,58
41,Chr1,9080607,9084622,9082615,4015
41,Chr1,10262446,10262456,10262451,10
41,Chr1,17804955,17806487,17805721,1532
41,Chr1,20602113,20602978,20602545,865
41,Chr1,21058758,21059587,21059172,829
41,Chr1,23513828,23513942,23513885,114
41,Chr2,1561026,1561453,1561240,427
41,Chr2,8938268,8938888,8938578,620
41,Chr2,10774095,10774506,10774301,411
41,Chr3,236785,241036,238911,4251
41,Chr3,2152167,2152703,2152435,536
41,Chr3,3438577,3440180,3439379,1603
41,Chr3,3772155,3773195,3772675,1040
41,Chr3,6491782,6492973,6492378,1191
41,Chr3,19994579,19995870,19995225,1291
41,Chr3,20496296,20497930,20497113,1634
41,Chr4,9177494,9178788,9178141,1294
41,Chr4,9765962,9766760,9766361,798
41,Chr4,12084643,12084892,12084767,249
41,Chr4,13848428,13850690,13849559,2262
41,Chr5,5346059,5348030,5347045,1971
41,Chr5,7978365,7979031,7978698,666
41,Chr5,19857473,19857934,19857703,461
41,Chr5,22358987,22359039,22359013,52
42,Chr1,971198,986719,978958,15521
42,Chr1,4694570,4709570,4702070,15000
42,Chr1,5421597,5421942,5421769,345
42,Chr1,18398774,18399170,18398972,396
42,Chr1,27306451,27306594,27306523,143
42,Chr1,28732706,28739401,28736054,6695
42,Chr1,30319504,30323611,30321558,4107
42,Chr3,248769,248864,248817,95
42,Chr3,3658681,3659291,3658986,610
42,Chr3,6659021,6661154,6660087,2133
42,Chr3,11753578,11755101,11754340,1523
42,Chr3,18839288,18839410,18839349,122
42,Chr3,21747587,21747784,21747685,197
42,Chr4,6394329,6394346,6394337,17
42,Chr4,14361934,14366433,14364184,4499
42,Chr5,3981941,3987166,3984553,5225
42,Chr5,7111750,7113177,7112464,1427
42,Chr5,17727651,17727796,17727723,145
42,Chr5,19284593,19284769,19284681,176
42,Chr5,23779637,23779814,23779725,177
43,Chr1,3321865,3323366,3322615,1501
43,Chr1,3938146,4010265,3974206,72119
43,Chr1,6361704,6362732,6362218,1028
43,Chr1,9333819,9334171,9333995,352
43,Chr1,22172956,22173452,22173204,496
43,Chr1,29428569,29429262,29428915,693
43,Chr1,30247300,30248691,30247996,1391
43,Chr2,10380056,10380524,10380290,468
43,Chr2,17472853,17473716,17473285,863
43,Chr3,264687,265272,264979,585
43,Chr3,3479311,3479761,3479536,450
43,Chr3,3947515,3947520,3947517,5
43,Chr3,4444826,4452589,4448708,7763
43,Chr3,5078539,5078771,5078655,232
43,Chr3,6122982,6123111,6123046,129
43,Chr3,18534980,18536000,18535490,1020
43,Chr3,21059941,21060983,21060462,1042
43,Chr3,21797154,21797486,21797320,332
43,Chr3,22641411,22641790,22641601,379
43,Chr4,6744141,6744663,6744402,522
43,Chr4,11132313,11134091,11133202,1778
43,Chr4,12860840,12861542,12861191,702
43,Chr4,13617095,13617709,13617402,614
43,Chr4,14129731,14133814,14131773,4083
43,Chr4,18435510,18439230,18437370,3720
43,Chr5,315242,315775,315508,533
43,Chr5,2606357,2607548,2606953,1191
43,Chr5,6812603,6814476,6813539,1873
43,Chr5,9582963,9582999,9582981,36
43,Chr5,18290693,18290799,18290746,106
43,Chr5,22637133,22637309,22637221,176
43,Chr5,26488626,26488718,26488672,92
44,Chr1,1159159,1159686,1159423,527
44,Chr1,4694570,4709570,4702070,15000
44,Chr1,10262456,10262630,10262543,174
44,Chr1,17857859,17858787,17858323,928
44,Chr1,20366844,20368762,20367803,1918
44,Chr1,20813510,20814814,20814162,1304
44,Chr1,21637438,21638257,21637848,819
44,Chr1,25222500,25223023,25222762,523
44,Chr1,29271733,29272070,29271901,337
44,Chr1,29494260,29495433,29494846,1173
44,Chr1,30241511,30241606,30241559,95
44,Chr2,8105869,8140037,8122953,34168
44,Chr2,15230365,15233618,15231991,3253
44,Chr2,17035159,17036657,17035908,1498
44,Chr2,18741472,18743487,18742480,2015
44,Chr3,1386157,1386425,1386291,268
44,Chr3,1924425,1924957,1924691,532
44,Chr3,2365361,2366785,2366073,1424
44,Chr3,6529843,6532077,6530960,2234
44,Chr3,7053389,7064120,7058755,10731
44,Chr3,11285469,11285987,11285728,518
44,Chr3,18026945,18027033,18026989,88
44,Chr3,18558911,18559277,18559094,366
44,Chr3,21017582,21018041,21017812,459
44,Chr3,23170730,23171037,23170884,307
44,Chr4,8647743,8648212,8647977,469
44,Chr4,8868239,8868616,8868427,377
44,Chr4,9996262,9996537,9996400,275
44,Chr4,11277176,11278514,11277845,1338
44,Chr4,13832324,13838058,13835191,5734
44,Chr4,18398969,18401190,18400079,2221
44,Chr5,158608,160914,159761,2306
44,Chr5,1609465,1610302,1609883,837
44,Chr5,21030598,21031097,21030848,499
44,Chr5,25313371,25313386,25313379,15
44,Chr5,25922647,25923245,25922946,598
45,Chr1,858097,986719,922408,128622
45,Chr1,4071979,4074834,4073407,2855
45,Chr1,18652135,18653396,18652765,1261
45,Chr1,19555055,19555231,19555143,176
45,Chr1,26768271,26768814,26768543,543
45,Chr2,10283657,10283773,10283715,116
45,Chr2,18632600,18632612,18632606,12
45,Chr3,4672287,4673496,4672891,1209
45,Chr3,6782597,6784210,6783403,1613
45,Chr3,17494951,17495278,17495115,327
45,Chr3,18142585,18142786,18142685,201
45,Chr3,19299801,19301717,19300759,1916
45,Chr3,20013684,20013782,20013733,98
45,Chr4,7858298,7858321,7858310,23
45,Chr4,8169353,8169892,8169623,539
45,Chr4,11284102,11285233,11284668,1131
45,Chr5,210372,210792,210582,420
45,Chr5,3736216,3738362,3737289,2146
45,Chr5,5111417,5122196,5116807,10779
45,Chr5,7271557,7271654,7271605,97
45,Chr5,17028229,17028503,17028366,274
45,Chr5,20850145,20852335,20851240,2190
45,Chr5,22049258,22049368,22049313,110
45,Chr5,25034199,25035669,25034934,1470
45,Chr5,26458222,26458886,26458554,664
46,Chr1,1527562,1527974,1527768,412
46,Chr1,2846965,2847808,2847387,843
46,Chr1,4286216,4288731,4287474,2515
46,Chr1,17166446,17167700,17167073,1254
46,Chr1,18075913,18076114,18076013,201
46,Chr1,29692540,29693059,29692800,519
46,Chr2,1137220,1137223,1137222,3
46,Chr2,12108662,12124196,12116429,15534
46,Chr3,4766835,4768252,4767543,1417
46,Chr3,5755584,5756531,5756058,947
46,Chr3,6430259,6430900,6430579,641
46,Chr3,8543893,8544837,8544365,944
46,Chr3,10095157,10103469,10099313,8312
46,Chr3,18479365,18480165,18479765,800
46,Chr4,370835,370913,370874,78
46,Chr4,8431174,8431765,8431470,591
46,Chr5,3366516,3368234,3367375,1718
46,Chr5,5063144,5071235,5067190,8091
46,Chr5,7976949,7977536,7977243,587
46,Chr5,20753330,20754966,20754148,1636
46,Chr5,21751487,21763740,21757613,12253
46,Chr5,24700114,24707834,24703974,7720
47,Chr1,596554,598868,597711,2314
47,Chr1,1145010,1146913,1145962,1903
47,Chr1,1770033,1771681,1770857,1648
47,Chr1,3809743,3810112,3809927,369
47,Chr1,7467944,7469413,7468678,1469
47,Chr1,8863836,8864516,8864176,680
47,Chr1,11903456,11908372,11905914,4916
47,Chr1,16938059,16940189,16939124,2130
47,Chr1,17479808,17480216,17480012,408
47,Chr1,19101744,19102129,19101936,385
47,Chr1,27217137,27221454,27219295,4317
47,Chr1,27664173,27664416,27664295,243
47,Chr1,29208624,29208656,29208640,32
47,Chr1,30302969,30303865,30303417,896
47,Chr2,10613887,10621929,10617908,8042
47,Chr2,15996438,15996715,15996576,277
47,Chr2,17199664,17200171,17199918,507
47,Chr2,18477600,18480167,18478884,2567
47,Chr3,2255530,2257141,2256336,1611
47,Chr3,4491423,4491688,4491555,265
47,Chr3,5255720,5255728,5255724,8
47,Chr3,9959246,9959879,9959562,633
47,Chr3,17622564,17624029,17623296,1465
47,Chr3,19494423,19496080,19495251,1657
47,Chr3,21681549,21683115,21682332,1566
47,Chr4,8438675,8438745,8438710,70
47,Chr4,12578371,12578595,12578483,224
47,Chr4,12904891,12906720,12905805,1829
47,Chr4,13909638,13910624,13910131,986
47,Chr5,144389,144487,144438,98
47,Chr5,736664,737069,736866,405
47,Chr5,2646067,2650611,2648339,4544
47,Chr5,6222280,6223625,6222952,1345
47,Chr5,8242806,8244296,8243551,1490
47,Chr5,9868190,9869689,9868940,1499
47,Chr5,14517670,14517859,14517764,189
47,Chr5,23576656,23578912,23577784,2256
47,Chr5,25064471,25064599,25064535,128
48,Chr1,559506,560551,560028,1045
48,Chr1,1436602,1437868,1437235,1266
48,Chr1,2928356,2932360,2930358,4004
48,Chr1,3873770,3874889,3874330,1119
48,Chr1,21904197,21904664,21904431,467
48,Chr1,25617073,25617612,25617343,539
48,Chr2,13137936,13141824,13139880,3888
48,Chr2,15224222,15225630,15224926,1408
48,Chr2,16761657,16763799,16762728,2142
48,Chr2,17725175,17726371,17725773,1196
48,Chr3,116833,120693,118763,3860
48,Chr3,3072535,3073193,3072864,658
48,Chr3,4138125,4139095,4138610,970
48,Chr3,5045035,5045179,5045107,144
48,Chr3,17758155,17762991,17760573,4836
48,Chr3,19454378,19459510,19456944,5132
48,Chr3,22688591,22689434,22689013,843
48,Chr4,10852992,10853467,10853230,475
48,Chr4,11831412,11831735,11831574,323
48,Chr4,13086833,13086894,13086863,61
48,Chr4,18014140,18014352,18014246,212
48,Chr5,1565237,1566359,1565798,1122
48,Chr5,5609634,5609925,5609780,291
48,Chr5,8289822,8290084,8289953,262
48,Chr5,9162525,9163877,9163201,1352
48,Chr5,9863012,9863430,9863221,418
48,Chr5,14390421,14517859,14454140,127438
48,Chr5,15874951,15875825,15875388,874
48,Chr5,22359892,22360024,22359958,132
49,Chr1,614273,615954,615113,1681
49,Chr1,1207631,1208938,1208285,1307
49,Chr1,2822649,2825256,2823953,2607
49,Chr1,3351027,3354275,3352651,3248
49,Chr1,6640840,6641514,6641177,674
49,Chr1,8404397,8404598,8404497,201
49,Chr1,10755325,10756217,10755771,892
49,Chr1,16775611,16775665,16775638,54
49,Chr1,18682102,18682456,18682279,354
49,Chr1,19878258,19879711,19878984,1453
49,Chr1,21252174,21255402,21253788,3228
49,Chr1,24139563,24141658,24140611,2095
49,Chr1,29991189,29992022,29991605,833
49,Chr2,1137220,1137223,1137222,3
49,Chr2,1556205,1563204,1559705,6999
49,Chr2,8281565,8282007,8281786,442
49,Chr2,12017260,12022648,12019954,5388
49,Chr2,15101411,15103557,15102484,2146
49,Chr2,15203637,15209519,15206578,5882
49,Chr2,18145029,18154466,18149747,9437
49,Chr2,19009776,19010630,19010203,854
49,Chr3,205388,205565,205476,177
49,Chr3,1645225,1645647,1645436,422
49,Chr3,3666785,3668118,3667451,1333
49,Chr3,4437135,4439720,4438427,2585
49,Chr3,7322239,7323959,7323099,1720
49,Chr3,7879291,7879772,7879531,481
49,Chr3,19848251,19850716,19849483,2465
49,Chr3,23268267,23269839,23269053,1572
49,Chr3,23367453,23367685,23367569,232
49,Chr4,9259179,9259187,9259183,8
49,Chr4,14077224,14079016,14078120,1792
49,Chr4,18377845,18377959,18377902,114
49,Chr5,1641854,1643105,1642480,1251
49,Chr5,2082891,2082917,2082904,26
49,Chr5,7176572,7177646,7177109,1074
49,Chr5,9546464,9546603,9546534,139
49,Chr5,9581132,9582913,9582022,1781
49,Chr5,16816811,16817954,16817383,1143
49,Chr5,20014520,20016071,20015296,1551
49,Chr5,21989196,21990561,21989878,1365
49,Chr5,22999362,22999843,22999602,481
49,Chr5,23618220,23618382,23618301,162
49,Chr5,25621810,25622111,25621960,301
5,Chr1,5818363,5820915,5819639,2552
5,Chr1,10758874,10762248,10760561,3374
5,Chr1,24810448,24810892,24810670,444
5,Chr1,25539380,25549775,25544578,10395
5,Chr1,28123320,28124570,28123945,1250
5,Chr1,28567262,28568888,28568075,1626
5,Chr2,7325820,7326174,7325997,354
5,Chr2,13115264,13127258,13121261,11994
5,Chr3,3456387,3457085,3456736,698
5,Chr3,7930933,7931057,7930995,124
5,Chr3,16823015,16823828,16823421,813
5,Chr3,20791251,20792351,20791801,1100
5,Chr3,22324128,22331817,22327972,7689
5,Chr3,22886784,22886943,22886864,159
5,Chr4,960221,960459,960340,238
5,Chr4,1101381,1102670,1102025,1289
5,Chr4,13116446,13117679,13117062,1233
5,Chr4,14477440,14478530,14477985,1090
5,Chr4,18459841,18460539,18460190,698
5,Chr5,3958438,3981941,3970190,23503
5,Chr5,4356109,4356589,4356349,480
5,Chr5,5401938,5402636,5402287,698
5,Chr5,8236137,8236576,8236357,439
5,Chr5,17930045,17930527,17930286,482
5,Chr5,22768398,22770238,22769318,1840
5,Chr5,24810412,24812491,24811452,2079
50,Chr1,3116880,3121154,3119017,4274
50,Chr1,3914707,3916113,3915410,1406
50,Chr1,9463438,9463631,9463534,193
50,Chr1,10863773,10864371,10864072,598
50,Chr1,17180556,17180843,17180700,287
50,Chr1,18128622,18129787,18129204,1165
50,Chr1,29758610,29759065,29758838,455
50,Chr2,9229030,9229293,9229162,263
50,Chr2,11157029,11158558,11157793,1529
50,Chr2,14966680,14967750,14967215,1070
50,Chr3,3506849,3506986,3506917,137
50,Chr3,9838931,9841282,9840107,2351
50,Chr3,17764314,17765371,17764842,1057
50,Chr3,18367331,18367936,18367633,605
50,Chr3,19437406,19438818,19438112,1412
50,Chr3,20745427,20746113,20745770,686
50,Chr3,21453235,21465064,21459149,11829
50,Chr4,1148751,1149627,1149189,876
50,Chr4,9410071,9411352,9410711,1281
50,Chr4,9729971,9730209,9730090,238
50,Chr4,10157840,10159863,10158852,2023
50,Chr4,16129742,16134521,16132132,4779
50,Chr4,17235442,17235650,17235546,208
50,Chr5,4076781,4077107,4076944,326
50,Chr5,4745105,4746118,4745611,1013
50,Chr5,5899315,5899519,5899417,204
50,Chr5,9046830,9047635,9047232,805
50,Chr5,16865895,16867246,16866571,1351
50,Chr5,25976643,25976943,25976793,300
50,Chr5,26646418,26646433,26646426,15
51,Chr1,568341,568351,568346,10
51,Chr1,2374163,2374314,2374239,151
51,Chr1,5436280,5436859,5436570,579
51,Chr1,7582842,7583772,7583307,930
51,Chr1,9304817,9306076,9305447,1259
51,Chr1,10951985,10952807,10952396,822
51,Chr1,12030120,12037278,12033699,7158
51,Chr1,20383524,20387177,20385350,3653
51,Chr2,881005,881243,881124,238
51,Chr2,9907277,9907399,9907338,122
51,Chr2,11958488,11959932,11959210,1444
51,Chr2,12938212,12938902,12938557,690
51,Chr2,17253323,17290948,17272135,37625
51,Chr3,2491444,2492305,2491874,861
51,Chr3,5222951,5228089,5225520,5138
51,Chr3,7640651,7640677,7640664,26
51,Chr3,20262317,20262413,20262365,96
51,Chr3,23286273,23286523,23286398,250
51,Chr4,6939320,6940878,6940099,1558
51,Chr4,8649687,8649781,8649734,94
51,Chr4,12501355,12505974,12503665,4619
51,Chr4,13270644,13271338,13270991,694
51,Chr5,158429,158608,158519,179
51,Chr5,376468,376613,376540,145
51,Chr5,1269309,1269382,1269345,73
51,Chr5,3813465,3813863,3813664,398
51,Chr5,5271294,5271412,5271353,118
51,Chr5,6719776,6724211,6721994,4435
51,Chr5,8072244,8080970,8076607,8726
51,Chr5,16820334,16822401,16821368,2067
51,Chr5,20437029,20437184,20437107,155
51,Chr5,22713784,22718313,22716048,4529
51,Chr5,23227641,23229322,23228481,1681
51,Chr5,24700114,24707834,24703974,7720
51,Chr5,26286004,26287535,26286770,1531
51,Chr5,26862899,26863340,26863119,441
52,Chr1,1105328,1105667,1105498,339
52,Chr1,3089669,3090581,3090125,912
52,Chr1,8725524,8727332,8726428,1808
52,Chr1,8974329,8974635,8974482,306
52,Chr1,10261631,10262456,10262043,825
52,Chr1,17975935,17977946,17976941,2011
52,Chr1,21904197,21904664,21904431,467
52,Chr1,28291697,28293205,28292451,1508
52,Chr2,8887067,8887366,8887217,299
52,Chr2,10265120,10265397,10265258,277
52,Chr2,18950838,18951095,18950966,257
52,Chr3,1747615,1747817,1747716,202
52,Chr3,3612740,3612813,3612776,73
52,Chr3,5050158,5050831,5050494,673
52,Chr3,16845942,16848461,16847202,2519
52,Chr3,20266390,20267942,20267166,1552
52,Chr3,22197517,22198199,22197858,682
52,Chr3,22835558,22842900,22839229,7342
52,Chr3,23301199,23301852,23301525,653
52,Chr4,7998008,7998071,7998040,63
52,Chr4,10411356,10411609,10411482,253
52,Chr4,10643421,10644604,10644013,1183
52,Chr4,14123574,14124934,14124254,1360
52,Chr4,18320362,18321510,18320936,1148
52,Chr5,4275924,4276138,4276031,214
52,Chr5,4515544,4517118,4516331,1574
52,Chr5,7977789,7978365,7978077,576
52,Chr5,9088155,9088907,9088531,752
52,Chr5,20301293,20303307,20302300,2014
52,Chr5,21195203,21195654,21195429,451
52,Chr5,21763740,21765750,21764745,2010
52,Chr5,23119076,23144398,23131737,25322
52,Chr5,24908986,24909269,24909128,283
53,Chr1,523868,560551,542210,36683
53,Chr1,11444260,11444514,11444387,254
53,Chr1,17065396,17065920,17065658,524
53,Chr1,19768533,19768764,19768649,231
53,Chr1,24839562,24843579,24841570,4017
53,Chr1,25511836,25531005,25521420,19169
53,Chr2,227342,227603,227472,261
53,Chr2,855004,855059,855032,55
53,Chr2,8969535,8970375,8969955,840
53,Chr2,11508730,11509050,11508890,320
53,Chr2,15443566,15443989,15443778,423
53,Chr2,19046878,19047269,19047074,391
53,Chr3,2381065,2381819,2381442,754
53,Chr3,3173175,3173319,3173247,144
53,Chr3,22352955,22353345,22353150,390
53,Chr4,11789134,11789806,11789470,672
53,Chr4,12454994,12455160,12455077,166
53,Chr5,286921,290125,288523,3204
53,Chr5,1162611,1163086,1162849,475
53,Chr5,8894881,8895846,8895363,965
53,Chr5,19290813,19292377,19291595,1564
53,Chr5,25064599,25066558,25065579,1959
53,Chr5,26676447,26678489,26677468,2042
54,Chr1,1920307,1922238,1921273,1931
54,Chr1,7245011,7247423,7246217,2412
54,Chr1,9746631,9747175,9746903,544
54,Chr1,23220777,23221464,23221121,687
54,Chr1,25396451,25396741,25396596,290
54,Chr1,27426586,27426618,27426602,32
54,Chr1,28351083,28352200,28351641,1117
54,Chr2,422890,422967,422928,77
54,Chr2,6365984,6367104,6366544,1120
54,Chr2,10307986,10308968,10308477,982
54,Chr2,17456163,17458347,17457255,2184
54,Chr3,914781,915341,915061,560
54,Chr3,22980568,22982507,22981538,1939
54,Chr4,13793924,13816294,13805109,22370
54,Chr4,18554667,18555332,18554999,665
54,Chr5,4448079,4449324,4448701,1245
54,Chr5,8662705,8662801,8662753,96
54,Chr5,16376481,16376826,16376653,345
54,Chr5,20839978,20840380,20840179,402
54,Chr5,21592602,21593925,21593264,1323
54,Chr5,22388774,22388799,22388786,25
55,Chr1,3810162,3810388,3810275,226
55,Chr1,5021513,5035603,5028558,14090
55,Chr1,7087759,7088943,7088351,1184
55,Chr1,10088672,10091198,10089935,2526
55,Chr1,21510623,21510689,21510656,66
55,Chr1,24867891,24868914,24868403,1023
55,Chr1,27980651,27980999,27980825,348
55,Chr2,7709396,7709783,7709590,387
55,Chr2,8725658,8728749,8727204,3091
55,Chr2,11534165,11534244,11534205,79
55,Chr2,12322398,12324582,12323490,2184
55,Chr2,16682528,16694743,16688636,12215
55,Chr2,18228405,18259080,18243743,30675
55,Chr2,18689491,18690308,18689899,817
55,Chr3,602266,602485,602376,219
55,Chr3,3389776,3391265,3390520,1489
55,Chr3,10244336,10249734,10247035,5398
55,Chr3,18480165,18480774,18480469,609
55,Chr3,19175648,19180987,19178318,5339
55,Chr3,22835558,22842900,22839229,7342
55,Chr4,1508537,1508677,1508607,140
55,Chr4,14008971,14010253,14009612,1282
55,Chr4,14517191,14517494,14517343,303
55,Chr5,336963,338007,337485,1044
55,Chr5,1872781,1895107,1883944,22326
55,Chr5,3142217,3142402,3142309,185
55,Chr5,4337599,4338086,4337843,487
55,Chr5,5111417,5122196,5116807,10779
55,Chr5,7563448,7563663,7563556,215
55,Chr5,8676685,8677442,8677063,757
55,Chr5,9623594,9625739,9624666,2145
55,Chr5,10297904,10299341,10298622,1437
55,Chr5,23423335,23424331,23423833,996
55,Chr5,24730381,24730988,24730685,607
56,Chr1,730831,730948,730889,117
56,Chr1,971198,986719,978958,15521
56,Chr1,3506824,3506978,3506901,154
56,Chr1,4890219,4891958,4891089,1739
56,Chr1,6133975,6133992,6133983,17
56,Chr1,6531484,6531748,6531616,264
56,Chr1,9486668,9487034,9486851,366
56,Chr1,18669165,18671838,18670501,2673
56,Chr1,25309364,25310078,25309721,714
56,Chr1,25733775,25733822,25733799,47
56,Chr1,26654858,26657058,26655958,2200
56,Chr2,428322,428429,428376,107
56,Chr2,9024831,9025352,9025091,521
56,Chr2,11172886,11175391,11174138,2505
56,Chr2,11636854,11638933,11637894,2079
56,Chr2,13213769,13214377,13214073,608
56,Chr2,14016238,14016450,14016344,212
56,Chr2,14629459,14629569,14629514,110
56,Chr2,15122504,15124965,15123734,2461
56,Chr2,17063648,17064318,17063983,670
56,Chr2,17474265,17474357,17474311,92
56,Chr2,18049478,18049931,18049704,453
56,Chr2,19375298,19383373,19379336,8075
56,Chr3,2171679,2172186,2171933,507
56,Chr3,6719911,6720542,6720227,631
56,Chr3,18667224,18668323,18667774,1099
56,Chr3,20976100,20976514,20976307,414
56,Chr3,21720291,21721587,21720939,1296
56,Chr3,22763259,22763848,22763553,589
56,Chr4,6287156,6288204,6287680,1048
56,Chr4,10399964,10400371,10400168,407
56,Chr4,11356718,11357585,11357152,867
56,Chr4,18412600,18413480,18413040,880
56,Chr5,2032868,2033194,2033031,326
56,Chr5,3057149,3057365,3057257,216
56,Chr5,4050938,4055649,4053294,4711
56,Chr5,8668474,8668514,8668494,40
56,Chr5,15526084,15526559,15526322,475
56,Chr5,18513032,18517542,18515287,4510
56,Chr5,19564643,19566135,19565389,1492
56,Chr5,20149381,20186431,20167906,37050
56,Chr5,21522777,21522840,21522809,63
56,Chr5,25100138,25100212,25100175,74
56,Chr5,25131620,25132963,25132292,1343
57,Chr1,2815021,2816609,2815815,1588
57,Chr1,6853061,6853337,6853199,276
57,Chr1,9253745,9253881,9253813,136
57,Chr1,17148126,17148243,17148184,117
57,Chr1,23041366,23042685,23042026,1319
57,Chr1,24315487,24315719,24315603,232
57,Chr1,25603583,25605379,25604481,1796
57,Chr1,27310961,27312130,27311545,1169
57,Chr2,8185581,8188814,8187197,3233
57,Chr2,14148839,14149230,14149035,391
57,Chr2,15085484,15086025,15085754,541
57,Chr2,19597723,19598321,19598022,598
57,Chr3,5024984,5025557,5025270,573
57,Chr3,6210818,6211005,6210912,187
57,Chr3,7391049,7394284,7392667,3235
57,Chr3,19940469,19940909,19940689,440
57,Chr3,19999872,20000240,20000056,368
57,Chr3,23348303,23350060,23349181,1757
57,Chr4,948048,950698,949373,2650
57,Chr4,9298893,9299075,9298984,182
57,Chr4,10133255,10133300,10133277,45
57,Chr4,11605861,11608452,11607157,2591
57,Chr5,1539692,1540559,1540126,867
57,Chr5,2561888,2563732,2562810,1844
57,Chr5,2771998,2772959,2772478,961
57,Chr5,15979759,15980701,15980230,942
57,Chr5,22783957,22786032,22784995,2075
57,Chr5,24457928,24458046,24457987,118
57,Chr5,25238539,25239365,25238952,826
57,Chr5,25861458,25861529,25861494,71
58,Chr1,183808,207856,195832,24048
58,Chr1,2326373,2326865,2326619,492
58,Chr1,3448507,3449328,3448917,821
58,Chr1,7153166,7153779,7153472,613
58,Chr1,9306076,9308755,9307416,2679
58,Chr1,16901460,16906471,16903966,5011
58,Chr1,19041086,19043119,19042102,2033
58,Chr1,20892724,20893271,20892998,547
58,Chr1,29468188,29468474,29468331,286
58,Chr2,1563204,1564045,1563624,841
58,Chr2,8010458,8010770,8010614,312
58,Chr2,12258952,12261024,12259988,2072
58,Chr3,2347641,2348351,2347996,710
58,Chr3,4787639,4787905,4787772,266
58,Chr3,7083390,7084390,7083890,1000
58,Chr3,8142290,8142585,8142438,295
58,Chr3,16034701,16035050,16034875,349
58,Chr3,19090024,19090562,19090293,538
58,Chr4,10593291,10593394,10593343,103
58,Chr4,12175851,12180365,12178108,4514
58,Chr4,12977916,12978045,12977980,129
58,Chr4,14781609,14783886,14782747,2277
58,Chr4,15705031,15707178,15706105,2147
58,Chr4,18257463,18258018,18257741,555
58,Chr5,271872,277216,274544,5344
58,Chr5,4939341,4944539,4941940,5198
58,Chr5,13880565,13880739,13880652,174
58,Chr5,17609238,17609256,17609247,18
58,Chr5,23367341,23367861,23367601,520
58,Chr5,26001735,26004541,26003138,2806
59,Chr1,858097,933178,895637,75081
59,Chr1,1877586,1878162,1877874,576
59,Chr1,5455901,5456667,5456284,766
59,Chr1,6053479,6056864,6055171,3385
59,Chr1,7989545,7989712,7989629,167
59,Chr1,10678526,10680313,10679420,1787
59,Chr1,19630741,19637014,19633877,6273
59,Chr1,20936804,20937192,20936998,388
59,Chr1,26642117,26642866,26642491,749
59,Chr1,27975790,27975915,27975852,125
59,Chr1,29362072,29362482,29362277,410
59,Chr2,6688048,6688548,6688298,500
59,Chr2,8147855,8167350,8157603,19495
59,Chr2,18016344,18017622,18016983,1278
59,Chr2,19467608,19468251,19467930,643
59,Chr3,5019009,5019321,5019165,312
59,Chr3,7829504,7830705,7830104,1201
59,Chr3,14941889,14942319,14942104,430
59,Chr3,16032477,16034701,16033589,2224
59,Chr3,17687466,17690178,17688822,2712
59,Chr4,960459,963383,961921,2924
59,Chr4,6735864,6736283,6736074,419
59,Chr4,8205206,8206264,8205735,1058
59,Chr5,1107087,1107508,1107297,421
59,Chr5,2294069,2295201,2294635,1132
59,Chr5,5749451,5749730,5749591,279
59,Chr5,6348585,6348647,6348616,62
59,Chr5,19231171,19235580,19233375,4409
59,Chr5,20238668,20239156,20238912,488
59,Chr5,23347921,23348429,23348175,508
59,Chr5,23704980,23706422,23705701,1442
59,Chr5,25265310,25266388,25265849,1078
6,Chr1,752927,753480,753203,553
6,Chr1,1744109,1744246,1744177,137
6,Chr1,2806763,2808268,2807515,1505
6,Chr1,5507393,5507600,5507497,207
6,Chr1,17487859,17488254,17488057,395
6,Chr1,20565098,20565396,20565247,298
6,Chr1,27528437,27528686,27528561,249
6,Chr2,9076369,9078161,9077265,1792
6,Chr2,16456445,16456811,16456628,366
6,Chr3,913873,914779,914326,906
6,Chr3,2952432,2952858,2952645,426
6,Chr3,5243562,5243611,5243586,49
6,Chr3,19915364,19915473,19915418,109
6,Chr3,20856221,20856529,20856375,308
6,Chr3,21121142,21123015,21122078,1873
6,Chr3,22107508,22108440,22107974,932
6,Chr4,18465017,18465274,18465145,257
6,Chr5,20408894,20409267,20409080,373
6,Chr5,23686786,23687395,23687090,609
6,Chr5,25432844,25433302,25433073,458
60,Chr1,1243087,1282224,1262655,39137
60,Chr1,2072156,2078257,2075206,6101
60,Chr1,6089648,6090247,6089948,599
60,Chr1,6944366,6944592,6944479,226
60,Chr1,8111471,8111957,8111714,486
60,Chr1,8551464,8551544,8551504,80
60,Chr1,9113982,9115933,9114958,1951
60,Chr1,10295197,10295819,10295508,622
60,Chr1,19007991,19043119,19025555,35128
60,Chr1,20433803,20437144,20435473,3341
60,Chr1,23024936,23026167,23025552,1231
60,Chr1,25225683,25226372,25226027,689
60,Chr1,27357969,27358608,27358289,639
60,Chr1,28154412,28155350,28154881,938
60,Chr1,28742704,28745359,28744032,2655
60,Chr2,1156842,1159137,1157990,2295
60,Chr2,1567981,1567986,1567983,5
60,Chr2,7479746,7480711,7480228,965
60,Chr2,11717494,11718206,11717850,712
60,Chr2,15889601,15889664,15889633,63
60,Chr2,16957314,16957625,16957470,311
60,Chr3,429345,429879,429612,534
60,Chr3,1135564,1135633,1135598,69
60,Chr3,1337615,1340853,1339234,3238
60,Chr3,3290911,3308301,3299606,17390
60,Chr3,4011440,4015474,4013457,4034
60,Chr3,6616262,6619900,6618081,3638
60,Chr3,20338983,20342332,20340657,3349
60,Chr3,21413314,21435092,21424203,21778
60,Chr3,23308648,23309354,23309001,706
60,Chr4,790184,791303,790744,1119
60,Chr4,10342848,10343780,10343314,932
60,Chr4,11877030,11878121,11877576,1091
60,Chr4,17848102,17849597,17848850,1495
60,Chr5,4592301,4592348,4592325,47
60,Chr5,5431963,5433264,5432613,1301
60,Chr5,7261421,7262026,7261723,605
60,Chr5,21582122,21583628,21582875,1506
60,Chr5,22436278,22437219,22436748,941
60,Chr5,22852913,22853104,22853009,191
60,Chr5,24417407,24420522,24418965,3115
60,Chr5,26236674,26236814,26236744,140
60,Chr5,26809016,26809304,26809160,288
61,Chr1,4034601,4036434,4035517,1833
61,Chr1,11910292,11914409,11912350,4117
61,Chr1,21631696,21632538,21632117,842
61,Chr2,261926,261988,261957,62
61,Chr2,10296822,10297439,10297130,617
61,Chr2,17425050,17426338,17425694,1288
61,Chr3,1423930,1433139,1428534,9209
61,Chr3,5335485,5335660,5335573,175
61,Chr3,7619389,7622162,7620775,2773
61,Chr3,8201560,8202588,8202074,1028
61,Chr3,10365153,10366180,10365667,1027
61,Chr3,11282749,11285987,11284368,3238
61,Chr3,20842934,20844604,20843769,1670
61,Chr3,22217821,22218330,22218075,509
61,Chr3,23398423,23399078,23398751,655
61,Chr4,298954,299538,299246,584
61,Chr4,6545869,6547316,6546593,1447
61,Chr4,11413443,11413798,11413621,355
61,Chr4,16317167,16318223,16317695,1056
61,Chr4,16731452,16733820,16732636,2368
61,Chr5,206381,206669,206525,288
61,Chr5,14633943,14635257,14634600,1314
61,Chr5,25340699,25342664,25341681,1965
62,Chr1,7550345,7550537,7550441,192
62,Chr1,8103896,8103985,8103940,89
62,Chr1,9889077,9893580,9891329,4503
62,Chr1,16920883,16921380,16921131,497
62,Chr1,19682756,19683879,19683318,1123
62,Chr1,21099119,21100049,21099584,930
62,Chr1,27661970,27662727,27662348,757
62,Chr1,28420268,28420404,28420336,136
62,Chr1,28651893,28724228,28688061,72335
62,Chr1,29408709,29408979,29408844,270
62,Chr1,30357523,30358428,30357975,905
62,Chr2,982994,983775,983384,781
62,Chr2,7249654,7250361,7250008,707
62,Chr2,7712339,7712869,7712604,530
62,Chr2,11550193,11550831,11550512,638
62,Chr2,14880929,14884716,14882823,3787
62,Chr2,18465889,18466605,18466247,716
62,Chr3,3891630,3892680,3892155,1050
62,Chr3,4965114,4966851,4965982,1737
62,Chr3,6436777,6438442,6437609,1665
62,Chr3,7280992,7282681,7281836,1689
62,Chr3,9282025,9282156,9282091,131
62,Chr3,14762125,14762484,14762305,359
62,Chr3,16945213,16946799,16946006,1586
62,Chr3,18222155,18222562,18222359,407
62,Chr4,1524434,1525077,1524756,643
62,Chr4,6267524,6268926,6268225,1402
62,Chr4,10698349,10698579,10698464,230
62,Chr4,11755555,11756159,11755857,604
62,Chr4,13080147,13081233,13080690,1086
62,Chr4,13692562,13692686,13692624,124
62,Chr4,15182235,15184782,15183509,2547
62,Chr4,16428546,16431001,16429774,2455
62,Chr4,18119133,18119962,18119547,829
62,Chr5,980849,983519,982184,2670
62,Chr5,1687486,1692868,1690177,5382
62,Chr5,3541585,3542105,3541845,520
62,Chr5,5423602,5424100,5423851,498
62,Chr5,6892829,6893760,6893295,931
62,Chr5,18682941,18683425,18683183,484
62,Chr5,22356855,22357507,22357181,652
62,Chr5,24610390,24610608,24610499,218
62,Chr5,26009152,26009780,26009466,628
62,Chr5,26686946,26687481,26687214,535
63,Chr1,2105280,2106102,2105691,822
63,Chr1,2872224,2872882,2872553,658
63,Chr1,5035603,5054681,5045142,19078
63,Chr1,6559119,6561098,6560109,1979
63,Chr1,16641851,16642694,16642273,843
63,Chr1,19973483,19974306,19973895,823
63,Chr1,30313311,30314775,30314043,1464
63,Chr2,7097139,7102519,7099829,5380
63,Chr2,17822618,17824070,17823344,1452
63,Chr3,228383,230919,229651,2536
63,Chr3,3371744,3375074,3373409,3330
63,Chr3,19292300,19293107,19292704,807
63,Chr4,13361087,13361836,13361461,749
63,Chr5,6725277,6725283,6725280,6
63,Chr5,13644229,13644256,13644243,27
63,Chr5,14914792,14915796,14915294,1004
63,Chr5,21020081,21020823,21020452,742
64,Chr1,4064275,4064374,4064325,99
64,Chr1,5035603,5045043,5040323,9440
64,Chr1,7147761,7152505,7150133,4744
64,Chr1,25743643,25745926,25744785,2283
64,Chr1,26689069,26691911,26690490,2842
64,Chr2,102920,104435,103678,1515
64,Chr2,5663918,5664089,5664004,171
64,Chr2,10634617,10634893,10634755,276
64,Chr2,11884731,11886496,11885613,1765
64,Chr2,13840110,13840126,13840118,16
64,Chr2,14988687,14990038,14989363,1351
64,Chr3,2662828,2663472,2663150,644
64,Chr3,3989510,3990391,3989950,881
64,Chr3,5023151,5024022,5023587,871
64,Chr3,19936726,19936925,19936826,199
64,Chr4,5986330,5986767,5986548,437
64,Chr4,8570569,8571202,8570885,633
64,Chr4,12487066,12488272,12487669,1206
64,Chr4,13222470,13223464,13222967,994
64,Chr4,14396189,14397153,14396671,964
64,Chr4,16936337,16938726,16937531,2389
64,Chr4,17362722,17365000,17363861,2278
64,Chr5,1742494,1750107,1746300,7613
64,Chr5,3050076,3050127,3050102,51
64,Chr5,3881347,3891548,3886447,10201
64,Chr5,5939971,5940359,5940165,388
64,Chr5,22190259,22191441,22190850,1182
65,Chr1,6778253,6779303,6778778,1050
65,Chr1,9409598,9409824,9409711,226
65,Chr1,25237465,25238020,25237743,555
65,Chr1,28691673,28724228,28707951,32555
65,Chr1,30337457,30338199,30337828,742
65,Chr2,9997125,9997684,9997405,559
65,Chr2,15258220,15260611,15259416,2391
65,Chr2,17115697,17118282,17116989,2585
65,Chr3,69936,69939,69938,3
65,Chr3,2376591,2377372,2376981,781
65,Chr3,4191822,4202366,4197094,10544
65,Chr3,8687570,8689343,8688456,1773
65,Chr3,9960726,9962277,9961502,1551
65,Chr3,19448306,19448410,19448358,104
65,Chr3,19854833,19857095,19855964,2262
65,Chr3,20430634,20431624,20431129,990
65,Chr3,22134806,22135449,22135128,643
65,Chr3,23284008,23286523,23285266,2515
65,Chr4,210896,210929,210912,33
65,Chr4,8645876,8646844,8646360,968
65,Chr4,18508541,18508743,18508642,202
65,Chr5,1953388,1954091,1953740,703
65,Chr5,3408195,3409598,3408897,1403
65,Chr5,21024389,21025693,21025041,1304
65,Chr5,24557539,24558255,24557897,716
66,Chr1,3047732,3048231,3047982,499
66,Chr1,4854093,4855119,4854606,1026
66,Chr1,5399570,5400208,5399889,638
66,Chr1,7566682,7567426,7567054,744
66,Chr1,9065267,9074295,9069781,9028
66,Chr1,20373990,20380600,20377295,6610
66,Chr1,23871110,23871233,23871172,123
66,Chr1,28883552,28890014,28886783,6462
66,Chr2,10269727,10269847,10269787,120
66,Chr2,18384252,18385888,18385070,1636
66,Chr2,18521055,18523140,18522097,2085
66,Chr3,1753277,1753832,1753555,555
66,Chr3,3860375,3862256,3861315,1881
66,Chr3,4666422,4667582,4667002,1160
66,Chr3,5752528,5753611,5753070,1083
66,Chr3,6327350,6327717,6327534,367
66,Chr3,7113719,7116222,7114971,2503
66,Chr3,10021457,10022330,10021893,873
66,Chr3,10664848,10664856,10664852,8
66,Chr4,8391544,8393184,8392364,1640
66,Chr4,11572237,11572238,11572237,1
66,Chr5,2084020,2085884,2084952,1864
66,Chr5,5812088,5812297,5812192,209
66,Chr5,9427383,9428086,9427735,703
66,Chr5,17204557,17204753,17204655,196
66,Chr5,20050083,20051299,20050691,1216
66,Chr5,24726416,24726679,24726548,263
67,Chr1,858097,986719,922408,128622
67,Chr1,1424739,1426755,1425747,2016
67,Chr1,5570668,5572098,5571383,1430
67,Chr1,7741021,7742002,7741511,981
67,Chr1,8576111,8581335,8578723,5224
67,Chr1,12063693,12064317,12064005,624
67,Chr1,13077492,13078838,13078165,1346
67,Chr1,21376943,21377061,21377002,118
67,Chr1,28707111,28724228,28715669,17117
67,Chr2,1920106,1926794,1923450,6688
67,Chr2,9589746,9590293,9590020,547
67,Chr2,10786591,10790006,10788299,3415
67,Chr2,12298857,12298889,12298873,32
67,Chr2,13657674,13658502,13658088,828
67,Chr2,17358181,17358896,17358539,715
67,Chr3,3456387,3457085,3456736,698
67,Chr3,4424973,4424995,4424984,22
67,Chr3,9833701,9835136,9834419,1435
67,Chr3,17701430,17702385,17701908,955
67,Chr3,17785613,17790964,17788289,5351
67,Chr3,21764473,21767052,21765763,2579
67,Chr4,8438653,8438745,8438699,92
67,Chr5,4426143,4427543,4426843,1400
67,Chr5,20508868,20509096,20508982,228
67,Chr5,22662662,22665793,22664228,3131
67,Chr5,23834612,23835884,23835248,1272
67,Chr5,24906198,24907061,24906630,863
68,Chr1,1208938,1209662,1209300,724
68,Chr1,1568676,1569077,1568876,401
68,Chr1,3089011,3089144,3089077,133
68,Chr1,3674900,3676526,3675713,1626
68,Chr1,4741697,4741972,4741835,275
68,Chr1,5401735,5403687,5402711,1952
68,Chr1,8141653,8141793,8141723,140
68,Chr1,22520645,22520738,22520691,93
68,Chr1,23045597,23045673,23045635,76
68,Chr1,24551091,24551547,24551319,456
68,Chr1,25826130,25827825,25826978,1695
68,Chr1,28877269,28882651,28879960,5382
68,Chr1,29359581,29359772,29359677,191
68,Chr2,672681,673037,672859,356
68,Chr2,757267,758253,757760,986
68,Chr2,12799158,12799239,12799198,81
68,Chr2,13150333,13151493,13150913,1160
68,Chr2,14429546,14432310,14430928,2764
68,Chr2,14748309,14752080,14750195,3771
68,Chr2,17977344,17977404,17977374,60
68,Chr3,2354258,2354283,2354270,25
68,Chr3,2436447,2437222,2436835,775
68,Chr3,18209978,18211293,18210636,1315
68,Chr4,6255594,6255725,6255660,131
68,Chr4,9253609,9253974,9253791,365
68,Chr4,9843373,9843991,9843682,618
68,Chr4,12885858,12887197,12886528,1339
68,Chr5,1950465,1950801,1950633,336
68,Chr5,3580214,3583532,3581873,3318
68,Chr5,5739803,5741188,5740495,1385
68,Chr5,7181943,7182224,7182083,281
68,Chr5,8273614,8273789,8273702,175
68,Chr5,17051693,17051727,17051710,34
68,Chr5,23620125,23620617,23620371,492
68,Chr5,24939942,24940209,24940076,267
68,Chr5,26056326,26056588,26056457,262
69,Chr1,7496538,7497247,7496892,709
69,Chr1,8393795,8393960,8393877,165
69,Chr1,9313720,9314098,9313909,378
69,Chr1,29184175,29184778,29184477,603
69,Chr2,8678880,8680374,8679627,1494
69,Chr2,9743654,9745780,9744717,2126
69,Chr2,10147135,10147791,10147463,656
69,Chr2,13361973,13362925,13362449,952
69,Chr2,18072858,18075096,18073977,2238
69,Chr3,6913983,6914886,6914435,903
69,Chr3,16616415,16616592,16616503,177
69,Chr3,18157907,18162749,18160328,4842
69,Chr3,18575396,18576028,18575712,632
69,Chr3,19305641,19312262,19308951,6621
69,Chr4,1135657,1138019,1136838,2362
69,Chr4,8456652,8457115,8456884,463
69,Chr4,10807710,10808121,10807916,411
69,Chr5,78706,79777,79242,1071
69,Chr5,1392983,1394905,1393944,1922
69,Chr5,6163901,6166193,6165047,2292
69,Chr5,6668349,6668446,6668397,97
69,Chr5,8728973,8733909,8731441,4936
69,Chr5,18134564,18136406,18135485,1842
69,Chr5,19371638,19372267,19371952,629
69,Chr5,21032188,21032716,21032452,528
69,Chr5,22525695,22526654,22526175,959
69,Chr5,22964109,22966101,22965105,1992
7,Chr1,485402,489092,487247,3690
7,Chr1,20292375,20299394,20295885,7019
7,Chr1,24146602,24147680,24147141,1078
7,Chr1,26181853,26183278,26182565,1425
7,Chr2,524145,524213,524179,68
7,Chr2,10319669,10320774,10320221,1105
7,Chr2,10840606,10841653,10841130,1047
7,Chr2,11172886,11175391,11174138,2505
7,Chr3,3751346,3751413,3751380,67
7,Chr3,4909913,4911039,4910476,1126
7,Chr3,8240214,8240796,8240505,582
7,Chr3,9006051,9008154,9007103,2103
7,Chr3,10719465,10719604,10719535,139
7,Chr3,23186092,23186441,23186266,349
7,Chr4,10177952,10178269,10178110,317
7,Chr4,13354546,13356735,13355640,2189
7,Chr5,944634,944975,944804,341
7,Chr5,1305352,1306224,1305788,872
7,Chr5,3490063,3490519,3490291,456
7,Chr5,6757166,6766321,6761744,9155
7,Chr5,17779324,17779821,17779572,497
7,Chr5,18575177,18576957,18576067,1780
7,Chr5,23175151,23214138,23194645,38987
7,Chr5,23825710,23829238,23827474,3528
70,Chr1,314437,371972,343205,57535
70,Chr1,1348919,1382716,1365817,33797
70,Chr1,2723354,2725344,2724349,1990
70,Chr1,3248333,3248972,3248653,639
70,Chr1,6840706,6841218,6840962,512
70,Chr1,7691220,7691846,7691533,626
70,Chr1,8969808,8970455,8970132,647
70,Chr1,22831621,22831927,22831774,306
70,Chr1,24770801,24770871,24770836,70
70,Chr1,26119608,26120642,26120125,1034
70,Chr2,1561522,1563204,1562363,1682
70,Chr2,1960125,1960303,1960214,178
70,Chr2,13515246,13516222,13515734,976
70,Chr2,15037267,15039526,15038397,2259
70,Chr2,17240818,17240883,17240850,65
70,Chr3,2214714,2214730,2214722,16
70,Chr3,5124565,5135037,5129801,10472
70,Chr3,5753885,5754326,5754105,441
70,Chr3,7239032,7253758,7246395,14726
70,Chr3,10021457,10022330,10021893,873
70,Chr3,18751617,18752006,18751811,389
70,Chr3,23361275,23361793,23361534,518
70,Chr4,655654,657521,656588,1867
70,Chr4,8627406,8627490,8627448,84
70,Chr5,1920636,1921267,1920952,631
70,Chr5,2557865,2557984,2557925,119
70,Chr5,4476537,4476812,4476675,275
70,Chr5,9231553,9231562,9231557,9
70,Chr5,15880505,15880667,15880586,162
70,Chr5,18910849,18911007,18910928,158
70,Chr5,24416033,24416541,24416287,508
70,Chr5,26393929,26394294,26394111,365
71,Chr1,2105166,2105280,2105223,114
71,Chr1,4765888,4766415,4766152,527
71,Chr1,6698169,6698746,6698457,577
71,Chr1,8977128,8985127,8981128,7999
71,Chr1,9835290,9835326,9835308,36
71,Chr1,11818746,11818812,11818779,66
71,Chr1,18669165,18671030,18670097,1865
71,Chr1,20218150,20219843,20218996,1693
71,Chr1,21394137,21394918,21394527,781
71,Chr1,23400285,23400417,23400351,132
71,Chr1,25842060,25843026,25842543,966
71,Chr1,26931686,26931769,26931728,83
71,Chr1,27711984,27713583,27712784,1599
71,Chr1,28184066,28184503,28184284,437
71,Chr1,28732706,28739401,28736054,6695
71,Chr1,30282617,30282894,30282755,277
71,Chr2,539722,540281,540002,559
71,Chr2,5009289,5009689,5009489,400
71,Chr2,9308270,9317027,9312648,8757
71,Chr2,12228233,12231960,12230097,3727
71,Chr2,12956404,12957186,12956795,782
71,Chr2,15278555,15282113,15280334,3558
71,Chr2,18462676,18463587,18463132,911
71,Chr3,6170098,6171389,6170744,1291
71,Chr3,6668977,6672200,6670589,3223
71,Chr3,9854022,9855719,9854870,1697
71,Chr3,18890568,18892226,18891397,1658
71,Chr3,21133829,21134610,21134219,781
71,Chr3,23016150,23021445,23018798,5295
71,Chr4,11877007,11878121,11877564,1114
71,Chr5,30881,32222,31551,1341
71,Chr5,2284048,2285579,2284814,1531
71,Chr5,8831657,8831868,8831763,211
71,Chr5,9409797,9409977,9409887,180
71,Chr5,9855408,9855906,9855657,498
71,Chr5,20021816,20022009,20021912,193
71,Chr5,20659273,20659661,20659467,388
71,Chr5,22388799,22389436,22389117,637
72,Chr1,3481255,3481364,3481309,109
72,Chr1,4967219,4969845,4968532,2626
72,Chr1,8405137,8431089,8418113,25952
72,Chr1,22120635,22120894,22120765,259
72,Chr1,30154709,30155635,30155172,926
72,Chr2,1938561,1939171,1938866,610
72,Chr2,15897908,15898529,15898218,621
72,Chr2,16705716,16705894,16705805,178
72,Chr3,1366418,1369252,1367835,2834
72,Chr3,5483910,5485603,5484756,1693
72,Chr3,5749287,5752528,5750907,3241
72,Chr3,7263805,7267616,7265711,3811
72,Chr3,8041297,8041742,8041519,445
72,Chr3,8953457,8955460,8954459,2003
72,Chr4,9143062,9143537,9143300,475
72,Chr4,11901610,11902004,11901807,394
72,Chr4,14240464,14240632,14240548,168
72,Chr4,18483940,18484284,18484112,344
72,Chr5,2906942,2910749,2908846,3807
72,Chr5,3613652,3614388,3614020,736
72,Chr5,5283097,5283158,5283127,61
72,Chr5,6407946,6409787,6408866,1841
72,Chr5,9277680,9278060,9277870,380
72,Chr5,16425443,16425669,16425556,226
72,Chr5,25018244,25019796,25019020,1552
73,Chr1,2284235,2284698,2284467,463
73,Chr1,10970101,10970386,10970243,285
73,Chr1,20606644,20615934,20611289,9290
73,Chr1,24790959,24791503,24791231,544
73,Chr1,28425782,28425813,28425798,31
73,Chr1,28760401,28826609,28793505,66208
73,Chr2,1563204,1564045,1563624,841
73,Chr2,5769384,5770296,5769840,912
73,Chr2,12273550,12273567,12273558,17
73,Chr2,18002162,18003487,18002824,1325
73,Chr3,706560,707755,707158,1195
73,Chr3,1609690,1610407,1610048,717
73,Chr3,2359383,2360808,2360095,1425
73,Chr3,5079747,5079992,5079869,245
73,Chr3,7064120,7066932,7065526,2812
73,Chr3,9875257,9878950,9877103,3693
73,Chr3,19568176,19568320,19568248,144
73,Chr3,23186531,23187205,23186868,674
73,Chr4,764481,766605,765543,2124
73,Chr4,11169557,11170683,11170120,1126
73,Chr4,11638578,11639608,11639093,1030
73,Chr4,14517494,14520543,14519018,3049
73,Chr5,117157,117185,117171,28
73,Chr5,2822183,2831387,2826785,9204
73,Chr5,3829814,3830238,3830026,424
73,Chr5,7184049,7184448,7184249,399
73,Chr5,7473432,7473814,7473623,382
73,Chr5,16962373,16962581,16962477,208
73,Chr5,18803509,18803923,18803716,414
73,Chr5,25004234,25005060,25004647,826
74,Chr1,124467,126609,125538,2142
74,Chr1,560551,562860,561705,2309
74,Chr1,4538578,4538828,4538703,250
74,Chr1,7698972,7699053,7699012,81
74,Chr1,8946305,8946816,8946561,511
74,Chr1,17893651,17894339,17893995,688
74,Chr1,18499753,18500280,18500017,527
74,Chr1,19972763,19973483,19973123,720
74,Chr1,20796260,20797062,20796661,802
74,Chr1,25060311,25061240,25060775,929
74,Chr1,26464938,26464995,26464966,57
74,Chr1,28671057,28678743,28674900,7686
74,Chr1,29879672,29881671,29880672,1999
74,Chr2,626651,627212,626931,561
74,Chr2,8573344,8574489,8573916,1145
74,Chr2,10016629,10022624,10019627,5995
74,Chr2,11912159,11912447,11912303,288
74,Chr2,12101343,12104379,12102861,3036
74,Chr2,12923473,12923695,12923584,222
74,Chr2,13663123,13663832,13663477,709
74,Chr2,15338090,15338272,15338181,182
74,Chr2,16014478,16015479,16014978,1001
74,Chr2,17929123,17931518,17930321,2395
74,Chr3,256655,258416,257535,1761
74,Chr3,3601376,3601444,3601410,68
74,Chr3,4776041,4777349,4776695,1308
74,Chr3,6672200,6673441,6672820,1241
74,Chr3,8477420,8478364,8477892,944
74,Chr3,11189597,11192987,11191292,3390
74,Chr3,18372422,18374419,18373420,1997
74,Chr3,19946281,19946855,19946568,574
74,Chr3,20739247,20739742,20739495,495
74,Chr3,21142795,21143106,21142951,311
74,Chr3,22278989,22279058,22279023,69
74,Chr3,22818777,22818784,22818781,7
74,Chr4,11752742,11752819,11752780,77
74,Chr4,13245191,13245954,13245573,763
74,Chr4,13973705,13973951,13973828,246
74,Chr5,328702,329311,329006,609
74,Chr5,1307023,1307230,1307127,207
74,Chr5,2701706,2704015,2702860,2309
74,Chr5,4087798,4088453,4088126,655
74,Chr5,8225581,8225718,8225649,137
74,Chr5,16098470,16098721,16098596,251
74,Chr5,16927802,16929390,16928596,1588
75,Chr1,2380139,2380853,2380496,714
75,Chr1,3270822,3270896,3270859,74
75,Chr1,17898494,17898832,17898663,338
75,Chr1,18216002,18218041,18217022,2039
75,Chr1,26122022,26123782,26122902,1760
75,Chr1,27619769,27621673,27620721,1904
75,Chr1,28895903,28898023,28896963,2120
75,Chr2,15904198,15904857,15904528,659
75,Chr2,17645576,17645816,17645696,240
75,Chr2,18154466,18169172,18161819,14706
75,Chr3,397446,399699,398572,2253
75,Chr3,2214730,2215171,2214950,441
75,Chr3,6309250,6309578,6309414,328
75,Chr3,17254846,17258036,17256441,3190
75,Chr3,18452909,18455357,18454133,2448
75,Chr3,19854833,19857095,19855964,2262
75,Chr3,21169754,21172099,21170926,2345
75,Chr3,22340429,22340480,22340455,51
75,Chr3,23228002,23229739,23228870,1737
75,Chr4,8871234,8873168,8872201,1934
75,Chr5,1095575,1095922,1095749,347
75,Chr5,1579744,1580005,1579874,261
75,Chr5,1676273,1676368,1676321,95
75,Chr5,2351901,2352665,2352283,764
75,Chr5,8085492,8086475,8085984,983
75,Chr5,16904072,16904147,16904110,75
75,Chr5,18155913,18157145,18156529,1232
75,Chr5,18609725,18610485,18610105,760
75,Chr5,22660985,22661746,22661365,761
75,Chr5,24315917,24316327,24316122,410
75,Chr5,26051938,26052893,26052416,955
76,Chr1,2078474,2081411,2079942,2937
76,Chr1,4040943,4041654,4041299,711
76,Chr1,5293311,5293354,5293333,43
76,Chr1,19953085,19953189,19953137,104
76,Chr1,22540772,22541011,22540892,239
76,Chr1,22631639,22632164,22631901,525
76,Chr1,27154590,27155211,27154900,621
76,Chr1,30342943,30343024,30342983,81
76,Chr2,368988,369164,369076,176
76,Chr2,7097139,7102519,7099829,5380
76,Chr2,15412591,15414043,15413317,1452
76,Chr2,17477002,17477922,17477462,920
76,Chr2,17929123,17931518,17930321,2395
76,Chr3,2158923,2159858,2159391,935
76,Chr3,4710381,4714761,4712571,4380
76,Chr3,7374289,7374796,7374543,507
76,Chr3,19569688,19570529,19570108,841
76,Chr3,19929401,19931624,19930513,2223
76,Chr3,21002670,21003505,21003088,835
76,Chr3,21677904,21681549,21679726,3645
76,Chr4,323426,323490,323458,64
76,Chr4,7088946,7089381,7089164,435
76,Chr4,9250172,9252831,9251502,2659
76,Chr4,12065825,12066422,12066123,597
76,Chr4,18332236,18332552,18332394,316
76,Chr5,3275501,3280259,3277880,4758
76,Chr5,23601080,23604407,23602744,3327
76,Chr5,24673112,24673580,24673346,468
76,Chr5,25340699,25342664,25341681,1965
76,Chr5,26169516,26169901,26169708,385
76,Chr5,26496169,26496277,26496223,108
77,Chr1,1022802,1064221,1043512,41419
77,Chr1,1485507,1485573,1485540,66
77,Chr1,4529181,4529508,4529345,327
77,Chr1,5763138,5763541,5763340,403
77,Chr1,9039421,9039785,9039603,364
77,Chr1,10941545,10941771,10941658,226
77,Chr1,19538963,19539168,19539065,205
77,Chr1,20985936,20986471,20986204,535
77,Chr1,28441219,28441659,28441439,440
77,Chr1,29938918,29940890,29939904,1972
77,Chr2,382229,383692,382961,1463
77,Chr3,1453963,1455461,1454712,1498
77,Chr3,17693094,17693520,17693307,426
77,Chr3,18142849,18142884,18142867,35
77,Chr3,18663723,18664081,18663902,358
77,Chr3,20606771,20608165,20607468,1394
77,Chr3,21334296,21336885,21335590,2589
77,Chr4,12002698,12003153,12002926,455
77,Chr4,12920710,12921560,12921135,850
77,Chr4,13147055,13148553,13147804,1498
77,Chr4,14021695,14022004,14021849,309
77,Chr5,2753060,2754983,2754022,1923
77,Chr5,3842485,3842696,3842591,211
77,Chr5,7510990,7512385,7511688,1395
77,Chr5,15957051,15958098,15957575,1047
77,Chr5,17760828,17762290,17761559,1462
77,Chr5,20938824,20939300,20939062,476
77,Chr5,23117800,23119076,23118438,1276
77,Chr5,25978541,25978794,25978667,253
78,Chr1,7370243,7370436,7370339,193
78,Chr1,8009342,8009431,8009386,89
78,Chr1,8597800,8598752,8598276,952
78,Chr1,24647784,24648322,24648053,538
78,Chr1,25503091,25511836,25507463,8745
78,Chr1,26243915,26246494,26245205,2579
78,Chr1,27533488,27534110,27533799,622
78,Chr2,314949,315201,315075,252
78,Chr2,10030649,10030799,10030724,150
78,Chr2,12225387,12226000,12225693,613
78,Chr2,15474916,15475323,15475120,407
78,Chr2,18446211,18446594,18446403,383
78,Chr3,2359383,2363905,2361644,4522
78,Chr3,3599291,3599581,3599436,290
78,Chr3,4710381,4714761,4712571,4380
78,Chr3,6099673,6099737,6099705,64
78,Chr3,9755185,9755254,9755219,69
78,Chr3,10358741,10358847,10358794,106
78,Chr3,18200318,18200382,18200350,64
78,Chr3,20045512,20048494,20047003,2982
78,Chr3,20496296,20497930,20497113,1634
78,Chr3,21242250,21242296,21242273,46
78,Chr4,171714,173028,172371,1314
78,Chr4,14898304,14900825,14899564,2521
78,Chr4,17672413,17673622,17673017,1209
78,Chr4,18508541,18508743,18508642,202
78,Chr5,657684,660015,658850,2331
78,Chr5,1742494,1750107,1746300,7613
78,Chr5,2584404,2585269,2584836,865
78,Chr5,4163047,4164559,4163803,1512
78,Chr5,6399784,6400379,6400082,595
78,Chr5,7252549,7253081,7252815,532
78,Chr5,14299885,14300276,14300081,391
78,Chr5,16060027,16060083,16060055,56
78,Chr5,16201333,16201993,16201663,660
78,Chr5,20417265,20417692,20417479,427
78,Chr5,21308388,21309698,21309043,1310
78,Chr5,23297139,23297231,23297185,92
79,Chr1,3886218,3886494,3886356,276
79,Chr1,6877367,6877938,6877653,571
79,Chr1,8601741,8604446,8603093,2705
79,Chr1,11161869,11162022,11161945,153
79,Chr1,22379524,22382463,22380994,2939
79,Chr1,24912168,24913682,24912925,1514
79,Chr1,27450765,27451368,27451067,603
79,Chr1,28110403,28111942,28111173,1539
79,Chr1,29834659,29835109,29834884,450
79,Chr2,11036437,11038375,11037406,1938
79,Chr2,12108662,12124196,12116429,15534
79,Chr2,13305862,13305995,13305928,133
79,Chr2,13913348,13913690,13913519,342
79,Chr2,14899664,14900348,14900006,684
79,Chr2,16177707,16180192,16178949,2485
79,Chr2,16757784,16758307,16758046,523
79,Chr2,17999355,18000902,18000129,1547
79,Chr2,18338059,18338318,18338189,259
79,Chr3,6093787,6093970,6093879,183
79,Chr3,10244336,10249734,10247035,5398
79,Chr3,17624116,17624234,17624175,118
79,Chr3,19016484,19018098,19017291,1614
79,Chr3,21437888,21453235,21445562,15347
79,Chr4,858112,858298,858205,186
79,Chr4,17998858,18000059,17999458,1201
79,Chr5,228733,230215,229474,1482
79,Chr5,2578557,2579155,2578856,598
79,Chr5,3344615,3345934,3345275,1319
79,Chr5,4432324,4433730,4433027,1406
79,Chr5,6327609,6328712,6328161,1103
79,Chr5,13907046,13907263,13907154,217
79,Chr5,15971432,15972234,15971833,802
79,Chr5,19257099,19257726,19257413,627
79,Chr5,20405466,20406863,20406164,1397
79,Chr5,23255326,23261694,23258510,6368
8,Chr1,183808,207856,195832,24048
8,Chr1,634564,634639,634602,75
8,Chr1,1479099,1479546,1479323,447
8,Chr1,8431284,8431404,8431344,120
8,Chr1,8972918,8973727,8973322,809
8,Chr1,10148335,10148985,10148660,650
8,Chr1,22632212,22635277,22633744,3065
8,Chr1,23553040,23553804,23553422,764
8,Chr1,27682416,27683026,27682721,610
8,Chr1,28104025,28104322,28104173,297
8,Chr1,28742704,28745359,28744032,2655
8,Chr2,7443337,7444145,7443741,808
8,Chr2,8365210,8365685,8365448,475
8,Chr2,11018094,11020761,11019428,2667
8,Chr2,13281053,13281483,13281268,430
8,Chr2,14502524,14503040,14502782,516
8,Chr2,14965353,14967750,14966551,2397
8,Chr2,18154466,18169172,18161819,14706
8,Chr2,18873394,18874851,18874122,1457
8,Chr2,19535491,19537006,19536249,1515
8,Chr3,425714,429879,427796,4165
8,Chr3,9050895,9050960,9050927,65
8,Chr3,12451263,12451370,12451317,107
8,Chr3,17990167,17991215,17990691,1048
8,Chr3,19043120,19043520,19043320,400
8,Chr3,22291541,22293364,22292453,1823
8,Chr3,23222521,23222733,23222627,212
8,Chr4,1529163,1529792,1529477,629
8,Chr4,13823571,13832324,13827947,8753
8,Chr4,14517494,14520543,14519018,3049
8,Chr4,15229134,15229457,15229296,323
8,Chr4,17622602,17624261,17623432,1659
8,Chr5,3263603,3267691,3265647,4088
8,Chr5,4073312,4073933,4073622,621
8,Chr5,4518831,4518898,4518865,67
8,Chr5,6067540,6067905,6067722,365
8,Chr5,6999856,7000146,7000001,290
8,Chr5,17547095,17547256,17547175,161
8,Chr5,18082123,18098476,18090299,16353
8,Chr5,26254090,26254698,26254394,608
8,Chr5,26668491,26668585,26668538,94
80,Chr1,1145010,1146913,1145962,1903
80,Chr1,1555291,1555698,1555495,407
80,Chr1,5002166,5005687,5003926,3521
80,Chr1,12657193,12657679,12657436,486
80,Chr1,20967677,20967736,20967707,59
80,Chr1,26944028,26944405,26944216,377
80,Chr2,100077,100082,100079,5
80,Chr2,11623555,11626168,11624861,2613
80,Chr2,13308083,13309943,13309013,1860
80,Chr2,14625136,14625245,14625190,109
80,Chr2,18142609,18145029,18143819,2420
80,Chr3,121074,121525,121300,451
80,Chr3,293335,293370,293353,35
80,Chr3,1848637,1848866,1848751,229
80,Chr3,4437135,4439720,4438427,2585
80,Chr3,5002150,5002501,5002326,351
80,Chr3,6929981,6970532,6950257,40551
80,Chr3,7929647,7930051,7929849,404
80,Chr3,18022262,18022566,18022414,304
80,Chr3,21059941,21060983,21060462,1042
80,Chr3,21839137,21839769,21839453,632
80,Chr4,122489,122528,122509,39
80,Chr4,5828294,5828682,5828488,388
80,Chr4,13301804,13302921,13302362,1117
80,Chr4,13935608,13936574,13936091,966
80,Chr5,5546722,5559677,5553200,12955
80,Chr5,19680828,19680877,19680852,49
80,Chr5,20212202,20212376,20212289,174
80,Chr5,23990169,23990280,23990225,111
80,Chr5,25136853,25137433,25137143,580
81,Chr1,1124879,1131718,1128299,6839
81,Chr1,8004558,8004992,8004775,434
81,Chr1,10938134,10939329,10938732,1195
81,Chr1,26105465,26106075,26105770,610
81,Chr1,27855755,27855948,27855851,193
81,Chr1,28301133,28303611,28302372,2478
81,Chr2,7635456,7636240,7635848,784
81,Chr2,19360041,19361303,19360672,1262
81,Chr3,80615,80718,80667,103
81,Chr3,2668053,2671530,2669791,3477
81,Chr3,3254469,3279079,3266774,24610
81,Chr3,4561267,4562686,4561977,1419
81,Chr3,7930051,7930526,7930289,475
81,Chr3,18039363,18041060,18040211,1697
81,Chr3,20939219,20940190,20939705,971
81,Chr3,21673478,21677904,21675691,4426
81,Chr4,653829,653976,653903,147
81,Chr4,10465624,10466070,10465847,446
81,Chr4,14157872,14163219,14160546,5347
81,Chr5,782582,783375,782978,793
81,Chr5,3557212,3557252,3557232,40
81,Chr5,4220932,4221046,4220989,114
81,Chr5,7369051,7369132,7369091,81
81,Chr5,13804228,13804280,13804254,52
81,Chr5,25973880,25974625,25974252,745
82,Chr1,4739541,4740751,4740146,1210
82,Chr1,22217650,22218022,22217836,372
82,Chr1,30271128,30272114,30271621,986
82,Chr2,14506990,14507289,14507140,299
82,Chr2,18228405,18259080,18243743,30675
82,Chr2,19599107,19600110,19599609,1003
82,Chr3,3254469,3279079,3266774,24610
82,Chr3,22173992,22174226,22174109,234
82,Chr4,10592886,10593191,10593038,305
82,Chr5,2219231,2219396,2219313,165
82,Chr5,4465553,4465904,4465729,351
82,Chr5,5461864,5462236,5462050,372
82,Chr5,6664390,6667045,6665718,2655
82,Chr5,7804514,7805972,7805243,1458
82,Chr5,16945949,16945999,16945974,50
82,Chr5,21448271,21448916,21448593,645
83,Chr1,3547767,3549253,3548510,1486
83,Chr1,8728014,8728140,8728077,126
83,Chr1,10262446,10262456,10262451,10
83,Chr1,10690225,10691800,10691013,1575
83,Chr1,11657858,11659921,11658890,2063
83,Chr1,18390409,18390468,18390439,59
83,Chr1,21102263,21102529,21102396,266
83,Chr1,21935211,21936364,21935787,1153
83,Chr1,23520273,23520648,23520461,375
83,Chr1,25689938,25693964,25691951,4026
83,Chr1,26811885,26813498,26812691,1613
83,Chr1,27467089,27468843,27467966,1754
83,Chr2,346834,346898,346866,64
83,Chr2,7584618,7585124,7584871,506
83,Chr2,9224191,9226231,9225211,2040
83,Chr2,10745288,10745897,10745592,609
83,Chr2,17158433,17159753,17159093,1320
83,Chr2,18374412,18376967,18375690,2555
83,Chr2,19361663,19369113,19365388,7450
83,Chr3,3756632,3757220,3756926,588
83,Chr3,7084419,7084969,7084694,550
83,Chr3,9490195,9490350,9490273,155
83,Chr3,17643812,17643845,17643828,33
83,Chr3,18139579,18140594,18140087,1015
83,Chr3,21578115,21583952,21581033,5837
83,Chr4,526374,526673,526524,299
83,Chr4,10734177,10734269,10734223,92
83,Chr4,18552790,18552948,18552869,158
83,Chr5,1402288,1403981,1403134,1693
83,Chr5,2625476,2625498,2625487,22
83,Chr5,3275501,3280259,3277880,4758
83,Chr5,8112079,8112159,8112119,80
83,Chr5,15980701,15981173,15980937,472
83,Chr5,17185546,17185601,17185574,55
83,Chr5,23283003,23283059,23283031,56
83,Chr5,25732768,25733529,25733148,761
84,Chr1,971198,986719,978958,15521
84,Chr1,2288036,2288762,2288399,726
84,Chr1,2551150,2553100,2552125,1950
84,Chr1,7443207,7445310,7444259,2103
84,Chr1,9546478,9546847,9546662,369
84,Chr1,12417858,12420317,12419088,2459
84,Chr1,22930472,22958328,22944400,27856
84,Chr1,27469089,27472380,27470735,3291
84,Chr2,6677634,6686374,6682004,8740
84,Chr2,10100005,10102254,10101129,2249
84,Chr2,12814282,12816654,12815468,2372
84,Chr2,15203637,15209519,15206578,5882
84,Chr2,18228405,18259080,18243743,30675
84,Chr2,18779350,18780268,18779809,918
84,Chr3,1938749,1940540,1939645,1791
84,Chr3,2381057,2381065,2381061,8
84,Chr3,3047632,3047845,3047738,213
84,Chr3,4693101,4693169,4693135,68
84,Chr3,8897231,8898570,8897901,1339
84,Chr3,9470214,9472642,9471428,2428
84,Chr3,18465000,18465434,18465217,434
84,Chr3,20275593,20275838,20275715,245
84,Chr3,21683115,21685890,21684503,2775
84,Chr4,742861,744173,743517,1312
84,Chr4,6528381,6538283,6533332,9902
84,Chr4,9133701,9134400,9134051,699
84,Chr4,10945552,10945773,10945662,221
84,Chr4,11893282,11898058,11895670,4776
84,Chr4,14441801,14442396,14442099,595
84,Chr4,18319793,18320362,18320077,569
84,Chr5,1586092,1586461,1586276,369
84,Chr5,3409730,3412795,3411262,3065
84,Chr5,4639132,4639254,4639193,122
84,Chr5,5143497,5144573,5144035,1076
84,Chr5,5877057,5877305,5877181,248
84,Chr5,8917943,8919947,8918945,2004
84,Chr5,9390726,9391576,9391151,850
84,Chr5,20728977,20743993,20736485,15016
84,Chr5,25811393,25813847,25812620,2454
84,Chr5,26675975,26676209,26676092,234
85,Chr1,183808,207856,195832,24048
85,Chr1,1175046,1175561,1175304,515
85,Chr1,4530451,4531439,4530945,988
85,Chr1,9697283,9698430,9697857,1147
85,Chr1,10290177,10293357,10291767,3180
85,Chr1,19007704,19007991,19007848,287
85,Chr1,19686049,19686777,19686413,728
85,Chr1,23513083,23513828,23513455,745
85,Chr1,26689069,26692537,26690803,3468
85,Chr1,29310351,29311486,29310919,1135
85,Chr2,1015744,1025524,1020634,9780
85,Chr2,13676419,13678482,13677451,2063
85,Chr2,14472028,14474886,14473457,2858
85,Chr2,19490045,19490700,19490373,655
85,Chr3,886903,887018,886961,115
85,Chr3,4377061,4377450,4377255,389
85,Chr3,4763322,4766835,4765078,3513
85,Chr3,16496719,16497707,16497213,988
85,Chr3,17658956,17660340,17659648,1384
85,Chr3,20368218,20368224,20368221,6
85,Chr3,21240517,21241444,21240981,927
85,Chr3,22818777,22818784,22818781,7
85,Chr4,8570569,8571202,8570885,633
85,Chr4,11770174,11771820,11770997,1646
85,Chr5,3790083,3790705,3790394,622
85,Chr5,5417711,5417768,5417739,57
85,Chr5,6095990,6097186,6096588,1196
85,Chr5,9717038,9717917,9717478,879
85,Chr5,14915796,14916023,14915910,227
85,Chr5,15543027,15543928,15543477,901
85,Chr5,26088429,26089220,26088825,791
86,Chr1,183808,207856,195832,24048
86,Chr1,1282314,1382716,1332515,100402
86,Chr1,2965679,2966590,2966135,911
86,Chr1,11085393,11086475,11085934,1082
86,Chr1,18834774,18838124,18836449,3350
86,Chr1,24544134,24547927,24546030,3793
86,Chr1,25840092,25840998,25840545,906
86,Chr2,8105869,8140037,8122953,34168
86,Chr2,11291667,11291758,11291713,91
86,Chr2,14049264,14050588,14049926,1324
86,Chr2,17740547,17740629,17740588,82
86,Chr3,1436828,1437500,1437164,672
86,Chr3,2442206,2444719,2443462,2513
86,Chr3,3290911,3308301,3299606,17390
86,Chr3,5239186,5243540,5241363,4354
86,Chr3,6436777,6438442,6437609,1665
86,Chr3,18273852,18274633,18274242,781
86,Chr3,22435766,22436904,22436335,1138
86,Chr4,992640,999428,996034,6788
86,Chr4,1240217,1240867,1240542,650
86,Chr4,15859284,15859612,15859448,328
86,Chr4,16882099,16885547,16883823,3448
86,Chr4,18547686,18548499,18548092,813
86,Chr5,1687486,1692868,1690177,5382
86,Chr5,15608316,15608941,15608628,625
86,Chr5,24385652,24385722,24385687,70
86,Chr5,26573456,26573967,26573712,511
87,Chr1,3691561,3693394,3692477,1833
87,Chr1,4165539,4166258,4165899,719
87,Chr1,8146022,8146163,8146092,141
87,Chr1,9413786,9414996,9414391,1210
87,Chr1,9791118,9793428,9792273,2310
87,Chr1,11471209,11471403,11471306,194
87,Chr1,20272327,20276105,20274216,3778
87,Chr1,23572063,23572270,23572167,207
87,Chr1,26773025,26778696,26775861,5671
87,Chr2,15296662,15297052,15296857,390
87,Chr2,15366387,15367996,15367191,1609
87,Chr3,6123111,6123206,6123159,95
87,Chr3,7834139,7834455,7834297,316
87,Chr3,9806812,9807458,9807135,646
87,Chr3,17947068,17947639,17947354,571
87,Chr3,18543518,18543582,18543550,64
87,Chr3,21738096,21739772,21738934,1676
87,Chr3,22163918,22164323,22164120,405
87,Chr4,159725,160421,160073,696
87,Chr4,8298704,8301826,8300265,3122
87,Chr4,18076955,18077433,18077194,478
87,Chr5,521614,522414,522014,800
87,Chr5,1570412,1570483,1570448,71
87,Chr5,4782184,4782201,4782192,17
87,Chr5,16758174,16759627,16758900,1453
87,Chr5,26298084,26298385,26298234,301
88,Chr1,364128,371972,368050,7844
88,Chr1,649788,650324,650056,536
88,Chr1,2662473,2663605,2663039,1132
88,Chr1,5921853,5922465,5922159,612
88,Chr1,9142675,9143306,9142991,631
88,Chr1,10214544,10262456,10238500,47912
88,Chr1,17832304,17832913,17832608,609
88,Chr1,18649401,18650228,18649815,827
88,Chr1,20098542,20098742,20098642,200
88,Chr1,23984548,23985211,23984880,663
88,Chr1,28362736,28364685,28363710,1949
88,Chr2,11638933,11640989,11639961,2056
88,Chr2,12424259,12424612,12424435,353
88,Chr2,14261814,14262241,14262028,427
88,Chr2,15054209,15055071,15054640,862
88,Chr2,15570647,15570710,15570679,63
88,Chr2,17819388,17821308,17820348,1920
88,Chr2,18651261,18656755,18654008,5494
88,Chr3,397446,399699,398572,2253
88,Chr3,4492220,4494062,4493141,1842
88,Chr3,4759651,4763256,4761453,3605
88,Chr3,5259171,5259635,5259403,464
88,Chr3,21931482,21931613,21931548,131
88,Chr3,23272938,23276239,23274588,3301
88,Chr4,959101,959529,959315,428
88,Chr4,8311281,8311442,8311361,161
88,Chr4,12469138,12472918,12471028,3780
88,Chr4,13793924,13816294,13805109,22370
88,Chr4,15972935,15973947,15973441,1012
88,Chr4,17739728,17741025,17740376,1297
88,Chr5,2940528,2942234,2941381,1706
88,Chr5,4441017,4441148,4441083,131
88,Chr5,5952316,5952479,5952398,163
88,Chr5,7950301,7952157,7951229,1856
88,Chr5,17704384,17704517,17704450,133
88,Chr5,21331328,21332061,21331694,733
88,Chr5,26766446,26768820,26767633,2374
89,Chr1,3665767,3667203,3666485,1436
89,Chr1,5820915,5823605,5822260,2690
89,Chr1,7147761,7152505,7150133,4744
89,Chr1,20255999,20259919,20257959,3920
89,Chr1,25549775,25550178,25549977,403
89,Chr1,28425813,28431833,28428823,6020
89,Chr1,30377366,30378727,30378046,1361
89,Chr2,382229,383692,382961,1463
89,Chr2,817771,818442,818107,671
89,Chr2,1591727,1599008,1595367,7281
89,Chr2,17130436,17135363,17132900,4927
89,Chr3,2053742,2053780,2053761,38
89,Chr3,15996013,15997224,15996619,1211
89,Chr3,21681549,21683115,21682332,1566
89,Chr4,627989,629657,628823,1668
89,Chr4,12582382,12583387,12582884,1005
89,Chr5,1932790,1933106,1932948,316
89,Chr5,5073133,5111406,5092269,38273
89,Chr5,14973363,14973585,14973474,222
89,Chr5,23236064,23236099,23236082,35
89,Chr5,24132719,24132805,24132762,86
89,Chr5,24664321,24664823,24664572,502
9,Chr1,582805,583717,583261,912
9,Chr1,3714844,3715668,3715256,824
9,Chr1,4820863,4822116,4821489,1253
9,Chr1,5423652,5423997,5423824,345
9,Chr1,7183290,7183848,7183569,558
9,Chr1,17358058,17358898,17358478,840
9,Chr1,19007991,19043119,19025555,35128
9,Chr1,19529058,19530283,19529670,1225
9,Chr1,21052089,21057344,21054717,5255
9,Chr1,28642136,28651893,28647014,9757
9,Chr1,29276254,29276349,29276302,95
9,Chr2,1025193,1025524,1025359,331
9,Chr2,9112064,9112070,9112067,6
9,Chr2,9921899,9922001,9921950,102
9,Chr2,11175283,11175391,11175337,108
9,Chr2,14332066,14336533,14334300,4467
9,Chr2,15256146,15257882,15257014,1736
9,Chr2,19013031,19013900,19013465,869
9,Chr3,872072,872985,872528,913
9,Chr3,4434887,4437135,4436011,2248
9,Chr3,5374524,5375388,5374956,864
9,Chr3,10951884,10952335,10952110,451
9,Chr3,18150000,18154240,18152120,4240
9,Chr3,18456486,18456756,18456621,270
9,Chr3,23203568,23212132,23207850,8564
9,Chr4,9255960,9261360,9258660,5400
9,Chr4,12838184,12838879,12838532,695
9,Chr5,741834,743305,742570,1471
9,Chr5,2371201,2371568,2371385,367
9,Chr5,6384296,6384361,6384328,65
9,Chr5,14631294,14632004,14631649,710
9,Chr5,16607016,16607717,16607366,701
9,Chr5,25454602,25456139,25455370,1537
90,Chr1,126609,127093,126851,484
90,Chr1,858097,986719,922408,128622
90,Chr1,1435846,1436602,1436224,756
90,Chr1,3272537,3273280,3272909,743
90,Chr1,3730223,3730638,3730431,415
90,Chr1,5278755,5280134,5279445,1379
90,Chr1,8344919,8345288,8345103,369
90,Chr1,9500553,9501125,9500839,572
90,Chr1,11931202,11935580,11933391,4378
90,Chr1,20239390,20240262,20239826,872
90,Chr1,20321327,20333615,20327471,12288
90,Chr1,24052428,24053248,24052838,820
90,Chr1,28260323,28260571,28260447,248
90,Chr1,28823928,28826609,28825268,2681
90,Chr2,588753,588977,588865,224
90,Chr2,9307495,9307556,9307525,61
90,Chr2,10850046,10850192,10850119,146
90,Chr2,13916242,13916244,13916243,2
90,Chr2,15726397,15728631,15727514,2234
90,Chr2,16539806,16539851,16539828,45
90,Chr2,17399829,17407658,17403743,7829
90,Chr2,18072331,18072858,18072595,527
90,Chr2,19356821,19359761,19358291,2940
90,Chr3,479100,480313,479706,1213
90,Chr3,1307370,1308526,1307948,1156
90,Chr3,2928899,2929093,2928996,194
90,Chr3,3544346,3546186,3545266,1840
90,Chr3,5789712,5791783,5790748,2071
90,Chr3,16566529,16566849,16566689,320
90,Chr3,19182056,19182238,19182147,182
90,Chr3,20970923,20974054,20972489,3131
90,Chr3,23343200,23344080,23343640,880
90,Chr4,7986703,7987291,7986997,588
90,Chr4,12626720,12627018,12626869,298
90,Chr4,18116648,18118131,18117390,1483
90,Chr5,254952,255464,255208,512
90,Chr5,1181356,1181391,1181374,35
90,Chr5,1927708,1927887,1927798,179
90,Chr5,1998959,1999912,1999435,953
90,Chr5,2533409,2533590,2533499,181
90,Chr5,3270856,3272662,3271759,1806
90,Chr5,3771764,3774542,3773153,2778
90,Chr5,5433393,5433915,5433654,522
90,Chr5,7679219,7679724,7679471,505
90,Chr5,9303075,9303788,9303431,713
90,Chr5,10148720,10149204,10148962,484
90,Chr5,13708881,13712513,13710697,3632
90,Chr5,17675623,17679526,17677575,3903
90,Chr5,26804379,26804519,26804449,140
91,Chr1,1489200,1489236,1489218,36
91,Chr1,2679553,2684066,2681809,4513
91,Chr1,3351027,3354275,3352651,3248
91,Chr1,5535691,5538781,5537236,3090
91,Chr1,11191794,11192300,11192047,506
91,Chr1,27977370,27978540,27977955,1170
91,Chr2,2295363,2295426,2295395,63
91,Chr2,6357259,6357545,6357402,286
91,Chr2,8323631,8323848,8323739,217
91,Chr2,11148237,11148528,11148383,291
91,Chr3,254002,255349,254676,1347
91,Chr3,7181260,7182179,7181720,919
91,Chr3,11010213,11011282,11010747,1069
91,Chr3,19192218,19192458,19192338,240
91,Chr3,20527530,20527957,20527744,427
91,Chr3,21656386,21677904,21667145,21518
91,Chr3,22124831,22124884,22124857,53
91,Chr4,231656,233865,232760,2209
91,Chr4,851262,852842,852052,1580
91,Chr4,5740779,5741151,5740965,372
91,Chr4,6764353,6767714,6766033,3361
91,Chr4,9666053,9666730,9666391,677
91,Chr4,14822872,14823304,14823088,432
91,Chr4,16761671,16763628,16762649,1957
91,Chr4,18487205,18487984,18487595,779
91,Chr5,2043841,2044342,2044091,501
91,Chr5,2910749,2935997,2923373,25248
91,Chr5,4667102,4667437,4667270,335
91,Chr5,9299099,9299220,9299159,121
91,Chr5,10300913,10301025,10300969,112
91,Chr5,21504921,21506159,21505540,1238
91,Chr5,22636395,22636543,22636469,148
92,Chr1,6866345,6866720,6866533,375
92,Chr1,7739748,7741021,7740384,1273
92,Chr1,11108721,11108858,11108789,137
92,Chr1,22114133,22114287,22114210,154
92,Chr1,27888336,27888801,27888568,465
92,Chr1,29266364,29267276,29266820,912
92,Chr2,298576,298887,298732,311
92,Chr2,360673,365116,362895,4443
92,Chr2,7269188,7274728,7271958,5540
92,Chr3,331117,332042,331579,925
92,Chr3,8172463,8173451,8172957,988
92,Chr3,10050772,10050881,10050826,109
92,Chr3,21702338,21703030,21702684,692
92,Chr3,22816569,22816908,22816739,339
92,Chr4,7801540,7802436,7801988,896
92,Chr4,8222070,8222655,8222362,585
92,Chr4,10459681,10459733,10459707,52
92,Chr4,14119064,14120740,14119902,1676
92,Chr5,1776233,1776270,1776251,37
92,Chr5,19226793,19231171,19228982,4378
92,Chr5,20956949,20958102,20957525,1153
92,Chr5,25585132,25587322,25586227,2190
92,Chr5,26964863,26965149,26965006,286
93,Chr1,1004842,1022802,1013822,17960
93,Chr1,10647625,10647721,10647673,96
93,Chr1,11622264,11624440,11623352,2176
93,Chr1,29593566,29593756,29593661,190
93,Chr2,7274920,7275075,7274998,155
93,Chr2,7575686,7575813,7575750,127
93,Chr2,8580568,8581423,8580996,855
93,Chr2,9518183,9518341,9518262,158
93,Chr2,10363378,10367122,10365250,3744
93,Chr2,15989935,15990015,15989975,80
93,Chr2,19264792,19265372,19265082,580
93,Chr3,2145861,2145883,2145872,22
93,Chr3,7069031,7083390,7076211,14359
93,Chr3,11838476,11839139,11838808,663
93,Chr3,19786653,19787211,19786932,558
93,Chr3,21453235,21465064,21459149,11829
93,Chr3,21500370,21513104,21506737,12734
93,Chr3,22173799,22173900,22173849,101
93,Chr4,658358,658374,658366,16
93,Chr4,9819355,9819552,9819453,197
93,Chr4,12990220,12990334,12990277,114
93,Chr5,6337115,6337945,6337530,830
93,Chr5,18320487,18320658,18320573,171
93,Chr5,20127631,20149352,20138491,21721
93,Chr5,23307051,23308689,23307870,1638
93,Chr5,24458800,24460091,24459446,1291
94,Chr1,1550477,1550566,1550521,89
94,Chr1,4966392,4967219,4966806,827
94,Chr1,9172209,9173001,9172605,792
94,Chr1,17938284,17942688,17940486,4404
94,Chr1,20243276,20245070,20244173,1794
94,Chr1,26077095,26077198,26077147,103
94,Chr1,30246586,30247151,30246868,565
94,Chr2,1933690,1933781,1933736,91
94,Chr2,6542833,6543825,6543329,992
94,Chr2,7729644,7729721,7729682,77
94,Chr2,15905319,15906492,15905905,1173
94,Chr2,16052527,16052681,16052604,154
94,Chr2,16624873,16625449,16625161,576
94,Chr2,18909572,18911037,18910304,1465
94,Chr3,299064,302240,300652,3176
94,Chr3,736775,737676,737225,901
94,Chr3,1351507,1352064,1351785,557
94,Chr3,9914334,9914503,9914418,169
94,Chr3,18393024,18393418,18393221,394
94,Chr3,19269233,19269609,19269421,376
94,Chr3,20529781,20530472,20530127,691
94,Chr4,1374068,1374335,1374202,267
94,Chr4,1441078,1441275,1441176,197
94,Chr4,6062869,6063125,6062997,256
94,Chr4,13459423,13459847,13459635,424
94,Chr5,1750107,1753947,1752027,3840
94,Chr5,7251036,7251318,7251177,282
95,Chr1,993176,993410,993293,234
95,Chr1,1878162,1880425,1879294,2263
95,Chr1,5239052,5239629,5239340,577
95,Chr1,7060041,7060289,7060165,248
95,Chr1,9308755,9309865,9309310,1110
95,Chr1,19007704,19007991,19007848,287
95,Chr1,21904197,21904664,21904431,467
95,Chr1,22930488,22958328,22944408,27840
95,Chr1,24845783,24846283,24846033,500
95,Chr1,25269085,25270377,25269731,1292
95,Chr1,26778696,26782382,26780539,3686
95,Chr1,28441659,28454138,28447899,12479
95,Chr2,11112939,11114879,11113909,1940
95,Chr2,11519396,11523265,11521330,3869
95,Chr2,14388604,14390743,14389674,2139
95,Chr2,16682528,16694743,16688636,12215
95,Chr2,18228405,18259080,18243743,30675
95,Chr2,18800623,18803520,18802071,2897
95,Chr3,27414,28159,27786,745
95,Chr3,482030,482178,482104,148
95,Chr3,9387707,9387859,9387783,152
95,Chr3,9937969,9939262,9938615,1293
95,Chr3,17944454,17944766,17944610,312
95,Chr3,18806062,18806358,18806210,296
95,Chr3,20052968,20057719,20055344,4751
95,Chr3,23119887,23120487,23120187,600
95,Chr3,23338914,23339205,23339060,291
95,Chr4,407455,407600,407527,145
95,Chr4,12012152,12012603,12012378,451
95,Chr4,13781526,13793924,13787725,12398
95,Chr4,18552390,18552790,18552590,400
95,Chr5,3836395,3841919,3839157,5524
95,Chr5,4555929,4558087,4557008,2158
95,Chr5,5022799,5024301,5023550,1502
96,Chr1,5070376,5072878,5071627,2502
96,Chr1,7938703,7939066,7938885,363
96,Chr1,13048184,13048611,13048398,427
96,Chr1,18360131,18361539,18360835,1408
96,Chr1,19100025,19101111,19100568,1086
96,Chr1,19972763,19973483,19973123,720
96,Chr1,23517512,23517906,23517709,394
96,Chr1,25511836,25531005,25521420,19169
96,Chr1,28948971,28951221,28950096,2250
96,Chr1,29408709,29408979,29408844,270
96,Chr2,445657,446406,446031,749
96,Chr2,518040,518958,518499,918
96,Chr2,10852353,10853151,10852752,798
96,Chr2,11243078,11244000,11243539,922
96,Chr2,17488184,17489534,17488859,1350
96,Chr3,429345,429879,429612,534
96,Chr3,947345,949727,948536,2382
96,Chr3,2424543,2425988,2425265,1445
96,Chr3,3432928,3433036,3432982,108
96,Chr3,5287355,5288314,5287835,959
96,Chr3,5841869,5842670,5842269,801
96,Chr3,6436777,6438442,6437609,1665
96,Chr3,17211388,17211393,17211390,5
96,Chr3,18508048,18508971,18508510,923
96,Chr3,22380286,22380396,22380341,110
96,Chr4,6899706,6899742,6899724,36
96,Chr4,7491862,7492744,7492303,882
96,Chr4,11592812,11598346,11595579,5534
96,Chr4,12597209,12599024,12598117,1815
96,Chr4,13295060,13295075,13295068,15
96,Chr4,18504169,18504912,18504541,743
96,Chr5,284293,284520,284407,227
96,Chr5,1059618,1059888,1059753,270
96,Chr5,4877059,4881105,4879082,4046
96,Chr5,6277356,6277869,6277612,513
96,Chr5,15896793,15898386,15897589,1593
96,Chr5,18742679,18742791,18742735,112
96,Chr5,20069217,20069489,20069353,272
96,Chr5,22502093,22502315,22502204,222
96,Chr5,23086290,23086332,23086311,42
96,Chr5,24623831,24624620,24624225,789
96,Chr5,26749317,26750369,26749843,1052
