lib,chrs,start,stop,cos,width
1,Chr1,5054681,5070376,5062529,15695
1,Chr1,7194315,7195393,7194854,1078
1,Chr1,11467821,11468046,11467933,225
1,Chr1,19919436,19921013,19920224,1577
1,Chr1,20380600,20383524,20382062,2924
1,Chr1,21033943,21037466,21035705,3523
1,Chr1,23523471,23525614,23524543,2143
1,Chr1,30277066,30277548,30277307,482
1,Chr2,1718129,1719022,1718575,893
1,Chr2,7622691,7622860,7622775,169
1,Chr2,8233743,8233843,8233793,100
1,Chr2,9231599,9232544,9232071,945
1,Chr2,10022624,10022736,10022680,112
1,Chr2,11001897,11010953,11006425,9056
1,Chr2,14119760,14120633,14120196,873
1,Chr2,14853807,14853882,14853845,75
1,Chr2,15907525,15909048,15908287,1523
1,Chr2,19390264,19392568,19391416,2304
1,Chr3,10015784,10016130,10015957,346
1,Chr3,19633795,19637216,19635505,3421
1,Chr4,851262,852842,852052,1580
1,Chr4,9288965,9289392,9289179,427
1,Chr4,13658654,13658716,13658685,62
1,Chr5,3844047,3844843,3844445,796
1,Chr5,5210999,5211614,5211307,615
1,Chr5,7941689,7942118,7941903,429
1,Chr5,13763627,13768326,13765977,4699
10,Chr1,432547,445271,438909,12724
10,Chr1,1497234,1497552,1497393,318
10,Chr1,1497552,1502839,1500196,5287
10,Chr1,4527060,4529000,4528030,1940
10,Chr1,4967219,4969845,4968532,2626
10,Chr1,17931796,17938284,17935040,6488
10,Chr1,20411025,20414631,20412828,3606
10,Chr1,27410156,27414997,27412576,4841
10,Chr2,10270339,10270440,10270389,101
10,Chr2,12108662,12124196,12116429,15534
10,Chr2,13083123,13083366,13083245,243
10,Chr3,18804,18823,18814,19
10,Chr3,469557,471989,470773,2432
10,Chr3,1250997,1251000,1250999,3
10,Chr3,4437135,4439720,4438427,2585
10,Chr3,5764990,5766343,5765666,1353
10,Chr3,6705249,6705633,6705441,384
10,Chr3,8033512,8034094,8033803,582
10,Chr3,15604694,15604909,15604802,215
10,Chr3,19897652,19897820,19897736,168
10,Chr4,244787,245797,245292,1010
10,Chr4,7461544,7462068,7461806,524
10,Chr4,8605455,8606624,8606039,1169
10,Chr4,10798824,10799246,10799035,422
10,Chr4,12707210,12707717,12707464,507
10,Chr4,13592427,13612527,13602477,20100
10,Chr4,14119064,14120740,14119902,1676
10,Chr5,1507237,1507420,1507329,183
10,Chr5,3017258,3017342,3017300,84
10,Chr5,3829814,3830238,3830026,424
10,Chr5,8072244,8080970,8076607,8726
10,Chr5,20805528,20807633,20806580,2105
10,Chr5,23236099,23236306,23236203,207
10,Chr5,25444755,25445516,25445135,761
11,Chr1,2452949,2453600,2453275,651
11,Chr1,4366484,4366909,4366696,425
11,Chr1,9402409,9402845,9402627,436
11,Chr1,11767023,11767133,11767078,110
11,Chr1,18892612,18899696,18896154,7084
11,Chr1,22708947,22709175,22709061,228
11,Chr1,28911150,28912168,28911659,1018
11,Chr2,1497805,1497977,1497891,172
11,Chr2,15074999,15075195,15075097,196
11,Chr3,2656952,2657914,2657433,962
11,Chr3,3656591,3656877,3656734,286
11,Chr3,19737814,19737895,19737854,81
11,Chr3,20480562,20480903,20480732,341
11,Chr3,21468762,21492444,21480603,23682
11,Chr3,23229739,23242592,23236165,12853
11,Chr4,125589,126194,125891,605
11,Chr4,1213378,1213579,1213478,201
11,Chr4,14044027,14044059,14044043,32
11,Chr5,8498,9974,9236,1476
11,Chr5,1132224,1133094,1132659,870
11,Chr5,6833482,6834121,6833802,639
11,Chr5,6854159,6856376,6855267,2217
11,Chr5,16428883,16429814,16429349,931
11,Chr5,23097129,23098340,23097735,1211
11,Chr5,24011669,24012226,24011947,557
12,Chr1,1137318,1138098,1137708,780
12,Chr1,4841068,4841097,4841082,29
12,Chr1,5285102,5285150,5285126,48
12,Chr1,5773843,5776349,5775096,2506
12,Chr1,8163936,8163990,8163963,54
12,Chr1,11598354,11598488,11598421,134
12,Chr1,17252565,17252626,17252595,61
12,Chr1,23410600,23410657,23410628,57
12,Chr1,25309364,25310078,25309721,714
12,Chr2,6823586,6824261,6823924,675
12,Chr3,256542,256655,256598,113
12,Chr3,3284381,3290911,3287646,6530
12,Chr3,19016057,19016226,19016141,169
12,Chr4,150013,151540,150777,1527
12,Chr5,20010814,20011118,20010966,304
12,Chr5,24458295,24458390,24458343,95
12,Chr5,25922647,25923245,25922946,598
12,Chr5,26173024,26173378,26173201,354
13,Chr1,4949251,4953738,4951495,4487
13,Chr1,9730682,9739614,9735148,8932
13,Chr1,19007704,19007991,19007848,287
13,Chr1,20948514,20949886,20949200,1372
13,Chr1,25705175,25706351,25705763,1176
13,Chr1,30377340,30377366,30377353,26
13,Chr2,7258859,7259232,7259045,373
13,Chr2,10571002,10571603,10571302,601
13,Chr2,13389291,13389675,13389483,384
13,Chr2,14659515,14661903,14660709,2388
13,Chr2,15148970,15150062,15149516,1092
13,Chr2,17086526,17089012,17087769,2486
13,Chr2,17814036,17818369,17816202,4333
13,Chr3,847759,848068,847913,309
13,Chr3,2214714,2214730,2214722,16
13,Chr3,4264744,4266349,4265546,1605
13,Chr3,4830786,4833045,4831916,2259
13,Chr3,8652722,8653010,8652866,288
13,Chr3,16307124,16308355,16307740,1231
13,Chr3,16848736,16849062,16848899,326
13,Chr3,22164783,22165307,22165045,524
13,Chr3,23069690,23070105,23069898,415
13,Chr4,744173,745995,745084,1822
13,Chr4,7342765,7343340,7343053,575
13,Chr4,9293542,9296171,9294856,2629
13,Chr4,11934744,11937057,11935900,2313
13,Chr4,12501355,12505974,12503665,4619
13,Chr5,19754,23126,21440,3372
13,Chr5,1536857,1538776,1537817,1919
13,Chr5,5309491,5309651,5309571,160
13,Chr5,5834044,5834236,5834140,192
13,Chr5,9968097,9968303,9968200,206
13,Chr5,20489099,20489496,20489297,397
13,Chr5,20943754,20944301,20944028,547
13,Chr5,25199080,25200627,25199854,1547
14,Chr1,3445451,3445639,3445545,188
14,Chr1,5099099,5100561,5099830,1462
14,Chr1,10338964,10342787,10340876,3823
14,Chr1,11682342,11683343,11682842,1001
14,Chr1,25635818,25638424,25637121,2606
14,Chr2,7283849,7284313,7284081,464
14,Chr2,7719655,7720078,7719867,423
14,Chr2,10858432,10858811,10858622,379
14,Chr2,11938498,11939797,11939148,1299
14,Chr2,14651006,14655825,14653416,4819
14,Chr2,15081666,15082680,15082173,1014
14,Chr2,17365717,17365827,17365772,110
14,Chr2,18538841,18539861,18539351,1020
14,Chr3,388609,389200,388905,591
14,Chr3,1307188,1308526,1307857,1338
14,Chr3,4123260,4124302,4123781,1042
14,Chr3,9737226,9737403,9737314,177
14,Chr3,17240075,17240209,17240142,134
14,Chr3,19555252,19557061,19556156,1809
14,Chr3,21932399,21933117,21932758,718
14,Chr4,428659,428864,428761,205
14,Chr4,927054,927805,927430,751
14,Chr4,8397582,8399352,8398467,1770
14,Chr4,9567611,9568339,9567975,728
14,Chr4,11898058,11898757,11898408,699
14,Chr4,11899582,11899652,11899617,70
14,Chr4,13781526,13793924,13787725,12398
14,Chr5,3078867,3079234,3079051,367
14,Chr5,4465553,4465904,4465729,351
14,Chr5,5521045,5524623,5522834,3578
14,Chr5,6951113,6951857,6951485,744
14,Chr5,19367476,19368236,19367856,760
14,Chr5,19995927,19996564,19996245,637
14,Chr5,20460571,20460871,20460721,300
14,Chr5,21283829,21284011,21283920,182
14,Chr5,24615071,24615859,24615465,788
14,Chr5,25759284,25761459,25760372,2175
15,Chr1,3248333,3248972,3248653,639
15,Chr1,12502802,12503733,12503268,931
15,Chr1,28856017,28859116,28857567,3099
15,Chr2,11756084,11756441,11756262,357
15,Chr2,17003052,17004248,17003650,1196
15,Chr3,1623226,1623671,1623448,445
15,Chr3,16622513,16624353,16623433,1840
15,Chr4,526673,526874,526773,201
15,Chr4,18001566,18002419,18001992,853
15,Chr4,18547686,18548499,18548092,813
15,Chr5,3993862,3994334,3994098,472
15,Chr5,5595849,5601001,5598425,5152
15,Chr5,6292097,6292278,6292187,181
15,Chr5,14517670,14517859,14517764,189
15,Chr5,14638500,14639533,14639016,1033
16,Chr1,5072878,5116528,5094703,43650
16,Chr1,8307685,8308186,8307935,501
16,Chr1,9166804,9166880,9166842,76
16,Chr1,11758556,11759744,11759150,1188
16,Chr1,22275069,22276137,22275603,1068
16,Chr1,22807915,22808208,22808061,293
16,Chr1,25723577,25723780,25723679,203
16,Chr1,28238620,28239662,28239141,1042
16,Chr1,30037691,30037771,30037731,80
16,Chr2,1127489,1128956,1128223,1467
16,Chr2,16231880,16232121,16232000,241
16,Chr2,16599493,16603294,16601393,3801
16,Chr2,19191789,19193993,19192891,2204
16,Chr3,2841199,2843850,2842525,2651
16,Chr3,7985263,7987074,7986169,1811
16,Chr3,18992075,18993233,18992654,1158
16,Chr3,19595156,19595927,19595542,771
16,Chr4,73968,75566,74767,1598
16,Chr4,13339878,13344754,13342316,4876
16,Chr5,405548,406925,406236,1377
16,Chr5,2464698,2465663,2465180,965
16,Chr5,6337115,6337945,6337530,830
16,Chr5,7003091,7004999,7004045,1908
16,Chr5,20220890,20222078,20221484,1188
16,Chr5,21306522,21307144,21306833,622
16,Chr5,22813932,22816931,22815432,2999
16,Chr5,25234489,25234919,25234704,430
16,Chr5,26207071,26208591,26207831,1520
17,Chr1,266733,266846,266789,113
17,Chr1,4529000,4529181,4529090,181
17,Chr1,6059360,6061846,6060603,2486
17,Chr1,17916654,17919363,17918008,2709
17,Chr1,25142069,25143543,25142806,1474
17,Chr1,25950651,25953552,25952101,2901
17,Chr2,362468,362541,362504,73
17,Chr2,1449847,1451259,1450553,1412
17,Chr2,8105869,8140037,8122953,34168
17,Chr2,9248719,9249552,9249135,833
17,Chr2,18349657,18350150,18349903,493
17,Chr2,19582892,19583487,19583190,595
17,Chr3,1210993,1214056,1212525,3063
17,Chr3,3217131,3217974,3217553,843
17,Chr3,3813434,3813760,3813597,326
17,Chr3,7633074,7633173,7633124,99
17,Chr3,18836237,18837460,18836849,1223
17,Chr3,20139374,20139548,20139461,174
17,Chr3,20734088,20734444,20734266,356
17,Chr3,21247571,21247821,21247696,250
17,Chr3,23290413,23291586,23290999,1173
17,Chr4,7285536,7286784,7286160,1248
17,Chr4,8607245,8608007,8607626,762
17,Chr4,10465624,10466070,10465847,446
17,Chr4,12512451,12512805,12512628,354
17,Chr4,17868392,17870544,17869468,2152
17,Chr5,33234,36968,35101,3734
17,Chr5,3830238,3836395,3833316,6157
17,Chr5,5693856,5694283,5694070,427
17,Chr5,17196179,17196352,17196265,173
17,Chr5,24950393,24952102,24951247,1709
17,Chr5,26228736,26229417,26229076,681
17,Chr5,26904251,26904414,26904333,163
18,Chr1,1282224,1282314,1282269,90
18,Chr1,2884591,2884808,2884699,217
18,Chr1,3507429,3512840,3510135,5411
18,Chr1,18875303,18875495,18875399,192
18,Chr1,19761612,19789214,19775413,27602
18,Chr1,27059583,27059688,27059635,105
18,Chr1,29393113,29393806,29393459,693
18,Chr2,7705493,7706447,7705970,954
18,Chr2,13781317,13782937,13782127,1620
18,Chr2,15210463,15211234,15210849,771
18,Chr2,17213410,17214757,17214084,1347
18,Chr2,19423665,19426368,19425017,2703
18,Chr3,2171679,2172186,2171933,507
18,Chr3,6398429,6399534,6398981,1105
18,Chr3,16421371,16421557,16421464,186
18,Chr3,19215305,19216013,19215659,708
18,Chr3,22917603,22917804,22917703,201
18,Chr4,1255641,1256367,1256004,726
18,Chr4,8972468,8973043,8972756,575
18,Chr4,10597830,10598094,10597962,264
18,Chr4,13653693,13656608,13655151,2915
18,Chr5,2068951,2070455,2069703,1504
18,Chr5,3871424,3881347,3876386,9923
18,Chr5,4680947,4681129,4681038,182
18,Chr5,5899879,5900369,5900124,490
18,Chr5,6850833,6852188,6851511,1355
18,Chr5,9837698,9838196,9837947,498
18,Chr5,16203435,16204134,16203785,699
18,Chr5,17742391,17742392,17742391,1
18,Chr5,19143274,19144203,19143738,929
18,Chr5,20939994,20941287,20940640,1293
18,Chr5,24070468,24071709,24071088,1241
19,Chr1,758274,760741,759508,2467
19,Chr1,1226581,1227493,1227037,912
19,Chr1,1727824,1730896,1729360,3072
19,Chr1,8106192,8107206,8106699,1014
19,Chr1,8993661,8993680,8993671,19
19,Chr1,10345699,10346645,10346172,946
19,Chr1,17938284,17942688,17940486,4404
19,Chr1,26007398,26008109,26007754,711
19,Chr1,26472214,26472579,26472396,365
19,Chr2,11012479,11013424,11012951,945
19,Chr2,11945702,11946537,11946120,835
19,Chr2,12783726,12784025,12783876,299
19,Chr2,15647619,15650096,15648857,2477
19,Chr3,623740,625997,624868,2257
19,Chr3,5483910,5485603,5484756,1693
19,Chr3,9916407,9918859,9917633,2452
19,Chr3,18751617,18752006,18751811,389
19,Chr4,796880,797345,797112,465
19,Chr4,7066072,7066756,7066414,684
19,Chr4,13512245,13513481,13512863,1236
19,Chr4,13863666,13864767,13864216,1101
19,Chr5,2392306,2392462,2392384,156
19,Chr5,20239156,20240595,20239876,1439
19,Chr5,21091469,21093257,21092363,1788
19,Chr5,26900086,26900331,26900208,245
2,Chr1,2617809,2618641,2618225,832
2,Chr1,3676526,3677300,3676913,774
2,Chr1,5962889,5963494,5963191,605
2,Chr1,8466044,8467887,8466966,1843
2,Chr1,20835838,20835976,20835907,138
2,Chr1,26367869,26371807,26369838,3938
2,Chr1,28932526,28934610,28933568,2084
2,Chr2,1318898,1319598,1319248,700
2,Chr2,2181177,2181296,2181237,119
2,Chr2,9033110,9033179,9033144,69
2,Chr2,14435885,14436421,14436153,536
2,Chr2,14852657,14852887,14852772,230
2,Chr2,17290948,17320860,17305904,29912
2,Chr3,5993405,5993459,5993432,54
2,Chr3,8911779,8912351,8912065,572
2,Chr3,17945438,17945561,17945500,123
2,Chr4,580220,581261,580740,1041
2,Chr4,1090170,1090639,1090404,469
2,Chr4,8822958,8823059,8823008,101
2,Chr4,9329343,9329501,9329422,158
2,Chr4,10796845,10797052,10796949,207
2,Chr4,12011358,12012603,12011980,1245
2,Chr4,12852098,12854594,12853346,2496
2,Chr5,9731741,9732589,9732165,848
2,Chr5,19160029,19162278,19161153,2249
2,Chr5,25568423,25570806,25569615,2383
20,Chr1,971198,986719,978958,15521
20,Chr1,5325156,5325572,5325364,416
20,Chr1,7925420,7929066,7927243,3646
20,Chr1,10721638,10722153,10721896,515
20,Chr1,18430897,18431785,18431341,888
20,Chr1,19108370,19110078,19109224,1708
20,Chr1,26538561,26539906,26539233,1345
20,Chr1,27517488,27518861,27518174,1373
20,Chr2,115824,116877,116350,1053
20,Chr2,7086375,7088080,7087227,1705
20,Chr3,3625424,3626515,3625970,1091
20,Chr3,8082158,8082171,8082164,13
20,Chr3,8692990,8693279,8693134,289
20,Chr3,19837877,19839003,19838440,1126
20,Chr4,8417854,8418315,8418084,461
20,Chr5,1414874,1415757,1415316,883
20,Chr5,6850833,6852188,6851511,1355
20,Chr5,7884017,7884455,7884236,438
20,Chr5,17511418,17511732,17511575,314
20,Chr5,20491441,20491826,20491633,385
20,Chr5,22764087,22764114,22764101,27
21,Chr1,1913764,1914650,1914207,886
21,Chr1,2909236,2910372,2909804,1136
21,Chr1,3113115,3116038,3114577,2923
21,Chr1,5289584,5293684,5291634,4100
21,Chr1,7370243,7370436,7370339,193
21,Chr1,9650898,9651388,9651143,490
21,Chr1,10535572,10536895,10536234,1323
21,Chr1,11671670,11672024,11671847,354
21,Chr1,17826059,17826232,17826145,173
21,Chr2,6959762,6959958,6959860,196
21,Chr2,11295356,11296174,11295765,818
21,Chr2,15158161,15158329,15158245,168
21,Chr2,18349657,18350150,18349903,493
21,Chr2,19145882,19147905,19146894,2023
21,Chr2,19687774,19689120,19688447,1346
21,Chr3,657775,659128,658451,1353
21,Chr3,5060615,5061066,5060841,451
21,Chr3,6179343,6179797,6179570,454
21,Chr3,7945274,7945317,7945296,43
21,Chr3,8623590,8623951,8623770,361
21,Chr3,18218504,18218559,18218532,55
21,Chr3,19910636,19911122,19910879,486
21,Chr4,6503011,6503029,6503020,18
21,Chr4,8244051,8251889,8247970,7838
21,Chr4,9363219,9365553,9364386,2334
21,Chr4,11867679,11868703,11868191,1024
21,Chr4,14404809,14404838,14404823,29
21,Chr5,3203685,3203751,3203718,66
21,Chr5,4652608,4653025,4652816,417
21,Chr5,18286336,18287502,18286919,1166
21,Chr5,20471672,20471730,20471701,58
21,Chr5,21355568,21356157,21355862,589
21,Chr5,22773905,22774562,22774233,657
22,Chr1,159122,159434,159278,312
22,Chr1,1243087,1282224,1262655,39137
22,Chr1,3806736,3808279,3807508,1543
22,Chr1,10825285,10826779,10826032,1494
22,Chr1,18515058,18515067,18515062,9
22,Chr1,21358496,21359304,21358900,808
22,Chr1,28671057,28724228,28697643,53171
22,Chr1,29517657,29519162,29518409,1505
22,Chr1,30220274,30222052,30221163,1778
22,Chr2,8105869,8140037,8122953,34168
22,Chr2,17409423,17413626,17411525,4203
22,Chr3,3308301,3308562,3308431,261
22,Chr3,3860375,3862256,3861315,1881
22,Chr4,10724520,10725403,10724962,883
22,Chr5,2315504,2316383,2315944,879
22,Chr5,5765705,5765845,5765775,140
22,Chr5,18672051,18673168,18672609,1117
22,Chr5,19907633,19908195,19907914,562
23,Chr1,1541172,1543645,1542408,2473
23,Chr1,5116659,5119148,5117903,2489
23,Chr1,5481137,5481514,5481325,377
23,Chr1,5973412,5973692,5973552,280
23,Chr1,8975583,8976103,8975843,520
23,Chr1,12974439,13006264,12990351,31825
23,Chr1,29386230,29386638,29386434,408
23,Chr2,9256626,9261510,9259068,4884
23,Chr2,10256858,10257350,10257104,492
23,Chr2,13377266,13380503,13378884,3237
23,Chr2,16250607,16250734,16250671,127
23,Chr2,18714373,18715904,18715139,1531
23,Chr3,2889198,2890621,2889910,1423
23,Chr3,5135037,5142262,5138649,7225
23,Chr3,6015611,6016966,6016289,1355
23,Chr3,6785361,6786404,6785883,1043
23,Chr3,18546575,18547090,18546833,515
23,Chr3,20519907,20520813,20520360,906
23,Chr3,22827302,22835558,22831430,8256
23,Chr4,5923975,5924099,5924037,124
23,Chr4,12229712,12230322,12230017,610
23,Chr4,13160117,13161081,13160599,964
23,Chr5,1502358,1503421,1502890,1063
23,Chr5,1677946,1679252,1678599,1306
23,Chr5,2517089,2517187,2517138,98
23,Chr5,13867572,13868750,13868161,1178
23,Chr5,16737756,16738016,16737886,260
23,Chr5,23248305,23255309,23251807,7004
24,Chr1,1423727,1423970,1423849,243
24,Chr1,8595014,8596430,8595722,1416
24,Chr1,18956064,18970944,18963504,14880
24,Chr1,25253343,25254725,25254034,1382
24,Chr1,26965671,26967135,26966403,1464
24,Chr1,30304493,30304689,30304591,196
24,Chr2,5679007,5680591,5679799,1584
24,Chr2,6179155,6179162,6179159,7
24,Chr2,7400658,7400818,7400738,160
24,Chr2,11147112,11147468,11147290,356
24,Chr2,15764408,15764744,15764576,336
24,Chr2,19361663,19369113,19365388,7450
24,Chr3,906827,906854,906841,27
24,Chr3,2910339,2911506,2910923,1167
24,Chr3,7965661,7966827,7966244,1166
24,Chr3,10244336,10249734,10247035,5398
24,Chr3,18661977,18662233,18662105,256
24,Chr3,19253752,19255707,19254730,1955
24,Chr3,20114895,20115975,20115435,1080
24,Chr3,21599287,21608492,21603889,9205
24,Chr3,23060901,23061380,23061141,479
24,Chr4,190806,200818,195812,10012
24,Chr4,9944029,9949468,9946749,5439
24,Chr5,1053718,1054689,1054204,971
24,Chr5,2085884,2086692,2086288,808
24,Chr5,2885142,2886999,2886070,1857
24,Chr5,3990159,3990883,3990521,724
24,Chr5,4632977,4634542,4633759,1565
24,Chr5,20149381,20186431,20167906,37050
24,Chr5,23158346,23165567,23161956,7221
24,Chr5,24738360,24739199,24738780,839
24,Chr5,25036433,25038001,25037217,1568
24,Chr5,25780696,25780748,25780722,52
25,Chr1,445595,446882,446239,1287
25,Chr1,3934385,3934409,3934397,24
25,Chr1,6405502,6410655,6408078,5153
25,Chr1,9050494,9062110,9056302,11616
25,Chr1,12686181,12687068,12686625,887
25,Chr1,18827149,18827708,18827429,559
25,Chr1,20602978,20605860,20604419,2882
25,Chr1,26550373,26550449,26550411,76
25,Chr1,26662496,26663272,26662884,776
25,Chr2,724023,728266,726145,4243
25,Chr2,857177,858030,857603,853
25,Chr2,2283811,2284201,2284006,390
25,Chr2,10457322,10457954,10457638,632
25,Chr2,14010029,14010288,14010159,259
25,Chr2,18462676,18463587,18463132,911
25,Chr2,19349079,19350861,19349970,1782
25,Chr2,19467608,19468251,19467930,643
25,Chr3,4377061,4378346,4377703,1285
25,Chr3,8866810,8871215,8869012,4405
25,Chr3,20801587,20802165,20801876,578
25,Chr3,22009541,22012959,22011250,3418
25,Chr4,976581,983150,979865,6569
25,Chr4,13063587,13066737,13065162,3150
25,Chr5,2033992,2034809,2034400,817
25,Chr5,4216649,4217338,4216993,689
25,Chr5,9722315,9722684,9722499,369
25,Chr5,21435966,21436508,21436237,542
25,Chr5,24753021,24757178,24755099,4157
25,Chr5,25466110,25466850,25466480,740
26,Chr1,797322,834960,816141,37638
26,Chr1,10681303,10682685,10681994,1382
26,Chr2,1989786,1989878,1989832,92
26,Chr2,10079906,10080539,10080222,633
26,Chr2,19580777,19581566,19581171,789
26,Chr3,8608412,8610873,8609642,2461
26,Chr3,21241444,21241579,21241512,135
26,Chr4,11566613,11569548,11568081,2935
26,Chr4,12474273,12479400,12476837,5127
26,Chr5,190991,192850,191921,1859
26,Chr5,3045674,3045785,3045730,111
26,Chr5,7953573,7953822,7953697,249
26,Chr5,25437589,25438668,25438129,1079
26,Chr5,25714176,25714674,25714425,498
27,Chr1,2744896,2744965,2744930,69
27,Chr1,10571749,10572372,10572061,623
27,Chr1,21262606,21266632,21264619,4026
27,Chr1,30299862,30300501,30300182,639
27,Chr2,12217028,12219101,12218064,2073
27,Chr2,12868351,12869964,12869157,1613
27,Chr2,17925170,17927744,17926457,2574
27,Chr3,674225,676677,675451,2452
27,Chr3,2894456,2897362,2895909,2906
27,Chr3,2904313,2911506,2907909,7193
27,Chr3,6521894,6529843,6525868,7949
27,Chr3,20365650,20367127,20366388,1477
27,Chr4,5660121,5660231,5660176,110
27,Chr4,7877234,7877383,7877308,149
27,Chr4,9134400,9134404,9134402,4
27,Chr4,12965613,12966506,12966059,893
27,Chr4,13463857,13463862,13463859,5
27,Chr5,1872781,1895107,1883944,22326
27,Chr5,6014017,6014320,6014169,303
27,Chr5,17713204,17713670,17713437,466
27,Chr5,19647940,19648133,19648036,193
27,Chr5,21226949,21227410,21227179,461
27,Chr5,26280965,26281017,26280991,52
28,Chr1,6529771,6529786,6529779,15
28,Chr1,7175613,7175615,7175614,2
28,Chr1,11469035,11469636,11469335,601
28,Chr1,20366844,20368762,20367803,1918
28,Chr1,23752420,23752970,23752695,550
28,Chr1,29875101,29878497,29876799,3396
28,Chr2,8167394,8168512,8167953,1118
28,Chr2,13812911,13818817,13815864,5906
28,Chr2,16318242,16319037,16318640,795
28,Chr2,16377503,16377825,16377664,322
28,Chr2,19051443,19051669,19051556,226
28,Chr2,19582502,19582660,19582581,158
28,Chr3,549625,554683,552154,5058
28,Chr3,1653409,1654434,1653921,1025
28,Chr3,4720551,4723166,4721859,2615
28,Chr3,7538150,7539400,7538775,1250
28,Chr3,10383897,10384263,10384080,366
28,Chr3,11463658,11465295,11464476,1637
28,Chr3,17513755,17513825,17513790,70
28,Chr3,21465064,21468762,21466913,3698
28,Chr4,697135,697258,697197,123
28,Chr4,12771205,12774893,12773049,3688
28,Chr4,13858064,13859640,13858852,1576
28,Chr4,14918516,14931665,14925090,13149
28,Chr4,15984152,15984894,15984523,742
28,Chr5,277368,278353,277860,985
28,Chr5,716439,717534,716987,1095
28,Chr5,2102470,2103906,2103188,1436
28,Chr5,2938597,2940277,2939437,1680
28,Chr5,4071991,4073312,4072651,1321
28,Chr5,22326375,22326626,22326501,251
28,Chr5,24531141,24531601,24531371,460
28,Chr5,25440234,25440631,25440432,397
28,Chr5,26132879,26133929,26133404,1050
29,Chr1,612952,614273,613612,1321
29,Chr1,2104632,2105166,2104899,534
29,Chr1,5813067,5814149,5813608,1082
29,Chr1,6224081,6227879,6225980,3798
29,Chr1,7153779,7154314,7154047,535
29,Chr1,13436918,13448718,13442818,11800
29,Chr1,28011825,28013331,28012578,1506
29,Chr1,29486920,29487344,29487132,424
29,Chr2,5951310,5953482,5952396,2172
29,Chr2,13804439,13804464,13804451,25
29,Chr2,14276414,14276588,14276501,174
29,Chr2,17651107,17651885,17651496,778
29,Chr2,19152124,19152441,19152282,317
29,Chr3,2146221,2147176,2146699,955
29,Chr3,2761022,2761183,2761102,161
29,Chr3,3592805,3594726,3593765,1921
29,Chr3,5142262,5165948,5154105,23686
29,Chr3,6097310,6098399,6097854,1089
29,Chr3,8218644,8219922,8219283,1278
29,Chr3,17534669,17535928,17535299,1259
29,Chr3,18064520,18064737,18064628,217
29,Chr3,22020697,22020875,22020786,178
29,Chr3,23279761,23280934,23280347,1173
29,Chr4,7948693,7948703,7948698,10
29,Chr4,8827453,8831411,8829432,3958
29,Chr4,11655732,11657678,11656705,1946
29,Chr4,11972753,11987179,11979966,14426
29,Chr5,4768672,4770609,4769640,1937
29,Chr5,6950804,6951113,6950958,309
29,Chr5,7976660,7976949,7976804,289
29,Chr5,24389082,24389762,24389422,680
29,Chr5,25938697,25940779,25939738,2082
29,Chr5,26730822,26731341,26731082,519
29,Chr5,26741775,26741815,26741795,40
3,Chr1,6015934,6017009,6016472,1075
3,Chr1,6241931,6242203,6242067,272
3,Chr1,7087633,7087759,7087696,126
3,Chr1,9196886,9198263,9197574,1377
3,Chr1,9650898,9651388,9651143,490
3,Chr1,18413347,18414693,18414020,1346
3,Chr1,23579374,23579435,23579404,61
3,Chr1,25393709,25395186,25394447,1477
3,Chr1,27991247,27991448,27991347,201
3,Chr1,28651893,28724228,28688061,72335
3,Chr1,30269554,30270428,30269991,874
3,Chr2,14880929,14884716,14882823,3787
3,Chr2,16780769,16782510,16781639,1741
3,Chr2,19261847,19263042,19262445,1195
3,Chr2,19506297,19507241,19506769,944
3,Chr3,324841,325360,325101,519
3,Chr3,1727244,1728216,1727730,972
3,Chr3,2177347,2178009,2177678,662
3,Chr3,6154292,6156010,6155151,1718
3,Chr3,8282126,8282562,8282344,436
3,Chr3,9970023,9971356,9970689,1333
3,Chr3,17551986,17552472,17552229,486
3,Chr3,20111122,20112540,20111831,1418
3,Chr4,11180642,11181127,11180884,485
3,Chr5,3342015,3343081,3342548,1066
3,Chr5,21893242,21893821,21893532,579
30,Chr1,71348,90571,80960,19223
30,Chr1,6813411,6813996,6813703,585
30,Chr1,8912860,8913326,8913093,466
30,Chr1,8926613,8926770,8926691,157
30,Chr1,9969869,9969934,9969901,65
30,Chr1,16623857,16624165,16624011,308
30,Chr1,18967126,19007704,18987415,40578
30,Chr1,21489927,21491078,21490503,1151
30,Chr1,25130009,25130811,25130410,802
30,Chr1,26835854,26836574,26836214,720
30,Chr1,28456198,28477388,28466793,21190
30,Chr1,29272070,29272614,29272342,544
30,Chr1,30209205,30209421,30209313,216
30,Chr2,9516312,9518183,9517248,1871
30,Chr2,17848787,17855602,17852195,6815
30,Chr3,682212,685110,683661,2898
30,Chr3,1870126,1870619,1870372,493
30,Chr3,3313590,3334922,3324256,21332
30,Chr3,11523980,11524278,11524129,298
30,Chr3,18815125,18816266,18815695,1141
30,Chr4,5317737,5335364,5326551,17627
30,Chr4,10836415,10837366,10836891,951
30,Chr4,11892575,11892908,11892741,333
30,Chr4,12871479,12877825,12874652,6346
30,Chr5,818990,819030,819010,40
30,Chr5,2522196,2523592,2522894,1396
30,Chr5,3547090,3547564,3547327,474
30,Chr5,4650512,4651560,4651036,1048
30,Chr5,6527432,6527837,6527634,405
30,Chr5,15363712,15363847,15363780,135
30,Chr5,18517542,18520256,18518899,2714
30,Chr5,21032188,21032716,21032452,528
30,Chr5,21776878,21778390,21777634,1512
30,Chr5,23255326,23261694,23258510,6368
31,Chr1,372675,377064,374869,4389
31,Chr1,850465,858097,854281,7632
31,Chr1,1749948,1750634,1750291,686
31,Chr1,9276879,9308755,9292817,31876
31,Chr1,10643882,10644588,10644235,706
31,Chr1,12447270,12447500,12447385,230
31,Chr1,19825157,19825475,19825316,318
31,Chr1,23804096,23805941,23805018,1845
31,Chr1,26280606,26280899,26280752,293
31,Chr1,28247505,28247579,28247542,74
31,Chr2,1060533,1062584,1061559,2051
31,Chr2,5072664,5072777,5072720,113
31,Chr2,6796694,6801370,6799032,4676
31,Chr2,11111265,11112386,11111825,1121
31,Chr2,15358043,15358214,15358129,171
31,Chr2,17396505,17399829,17398167,3324
31,Chr3,41293,41298,41295,5
31,Chr3,1494685,1495582,1495133,897
31,Chr3,2022335,2024124,2023229,1789
31,Chr3,7044650,7049755,7047202,5105
31,Chr3,19082713,19084363,19083538,1650
31,Chr3,21687087,21703030,21695059,15943
31,Chr4,12015950,12016766,12016358,816
31,Chr5,3549678,3550687,3550182,1009
31,Chr5,19367368,19367476,19367422,108
31,Chr5,24110772,24113378,24112075,2606
32,Chr1,1576472,1576617,1576544,145
32,Chr1,1644236,1647580,1645908,3344
32,Chr1,5683255,5683422,5683339,167
32,Chr1,6245127,6245229,6245178,102
32,Chr1,6682144,6683448,6682796,1304
32,Chr1,11142608,11144945,11143776,2337
32,Chr1,11975739,12002270,11989005,26531
32,Chr1,19102848,19104873,19103860,2025
32,Chr1,20983987,20984876,20984431,889
32,Chr1,27307928,27308343,27308136,415
32,Chr1,30366404,30369408,30367906,3004
32,Chr2,1172593,1173253,1172923,660
32,Chr2,7753532,7753629,7753580,97
32,Chr2,9476561,9479632,9478097,3071
32,Chr2,17814036,17818369,17816202,4333
32,Chr2,19285498,19287810,19286654,2312
32,Chr3,102795,104414,103605,1619
32,Chr3,6399534,6399886,6399710,352
32,Chr3,6841136,6841272,6841204,136
32,Chr3,8497369,8497891,8497630,522
32,Chr3,18645785,18647323,18646554,1538
32,Chr3,19625753,19626874,19626313,1121
32,Chr3,21738096,21739772,21738934,1676
32,Chr4,221797,222388,222093,591
32,Chr4,9944029,9949468,9946749,5439
32,Chr4,11217311,11219273,11218292,1962
32,Chr5,41563,44705,43134,3142
32,Chr5,1160264,1161099,1160682,835
32,Chr5,1707886,1708111,1707998,225
32,Chr5,4870456,4871236,4870846,780
32,Chr5,8072244,8080970,8076607,8726
32,Chr5,8775562,8777233,8776398,1671
32,Chr5,15749648,15750467,15750058,819
32,Chr5,16727416,16727795,16727606,379
32,Chr5,21717721,21718014,21717867,293
32,Chr5,25147837,25149443,25148640,1606
33,Chr1,88300,90571,89436,2271
33,Chr1,971198,986719,978958,15521
33,Chr1,6897344,6898729,6898036,1385
33,Chr1,22958252,22958328,22958290,76
33,Chr1,28327089,28327166,28327127,77
33,Chr2,881972,882115,882044,143
33,Chr2,2023986,2024893,2024440,907
33,Chr2,10567502,10568142,10567822,640
33,Chr2,11360158,11361691,11360924,1533
33,Chr2,14852657,14852887,14852772,230
33,Chr2,16982775,16984006,16983391,1231
33,Chr3,116833,120693,118763,3860
33,Chr3,9126881,9126970,9126925,89
33,Chr3,9481373,9481625,9481499,252
33,Chr3,22257003,22258419,22257711,1416
33,Chr3,23317997,23319484,23318741,1487
33,Chr4,5704386,5705252,5704819,866
33,Chr4,13936574,13939714,13938144,3140
33,Chr4,18479330,18481221,18480276,1891
33,Chr5,965775,968905,967340,3130
33,Chr5,2371824,2372609,2372216,785
33,Chr5,15212070,15212457,15212264,387
33,Chr5,17164446,17164548,17164497,102
33,Chr5,19275953,19276654,19276303,701
33,Chr5,21480488,21480748,21480618,260
33,Chr5,24374010,24374011,24374010,1
33,Chr5,25036433,25038001,25037217,1568
34,Chr1,1905859,1906852,1906355,993
34,Chr1,4931695,4932549,4932122,854
34,Chr1,7366336,7368226,7367281,1890
34,Chr1,12431148,12433284,12432216,2136
34,Chr1,18919208,19007991,18963600,88783
34,Chr1,20245070,20251024,20248047,5954
34,Chr1,22299503,22302768,22301135,3265
34,Chr1,26979632,26979934,26979783,302
34,Chr2,1492430,1493004,1492717,574
34,Chr2,7636240,7636620,7636430,380
34,Chr2,8680913,8681546,8681229,633
34,Chr2,16322054,16327384,16324719,5330
34,Chr2,19048343,19050712,19049527,2369
34,Chr3,303169,304406,303787,1237
34,Chr3,667932,668858,668395,926
34,Chr3,4978419,4978840,4978629,421
34,Chr3,7051506,7052140,7051823,634
34,Chr3,7864457,7866053,7865255,1596
34,Chr3,10412709,10412831,10412770,122
34,Chr3,18757439,18757483,18757461,44
34,Chr3,19928307,19928424,19928365,117
34,Chr3,20634490,20636332,20635411,1842
34,Chr4,10464251,10464699,10464475,448
34,Chr4,10884652,10886052,10885352,1400
34,Chr4,11583952,11584196,11584074,244
34,Chr4,12397283,12398899,12398091,1616
34,Chr4,13665396,13667273,13666334,1877
34,Chr4,14330660,14330899,14330780,239
34,Chr5,123516,123542,123529,26
34,Chr5,3123308,3125044,3124176,1736
34,Chr5,5899315,5899519,5899417,204
34,Chr5,10296719,10297103,10296911,384
34,Chr5,25247951,25249625,25248788,1674
35,Chr1,847535,850465,849000,2930
35,Chr1,10088047,10088672,10088359,625
35,Chr1,17856618,17856825,17856722,207
35,Chr1,19617482,19617698,19617590,216
35,Chr1,28521632,28521846,28521739,214
35,Chr2,8521555,8521677,8521616,122
35,Chr2,17195869,17196876,17196373,1007
35,Chr3,1848929,1848933,1848931,4
35,Chr3,4204000,4207718,4205859,3718
35,Chr3,5796295,5796865,5796580,570
35,Chr3,18012178,18012644,18012411,466
35,Chr3,21261365,21261922,21261643,557
35,Chr3,22971316,22978019,22974668,6703
35,Chr3,23391076,23393525,23392300,2449
35,Chr4,173780,173900,173840,120
35,Chr5,314630,315242,314936,612
35,Chr5,5945547,5947689,5946618,2142
35,Chr5,23513652,23515493,23514572,1841
35,Chr5,25983404,25984654,25984029,1250
36,Chr1,757817,757832,757825,15
36,Chr1,2867023,2870747,2868885,3724
36,Chr1,4320145,4322716,4321431,2571
36,Chr1,6499095,6499836,6499465,741
36,Chr1,8294866,8295815,8295340,949
36,Chr1,18801968,18802523,18802246,555
36,Chr1,25862648,25863642,25863145,994
36,Chr1,27403000,27404519,27403760,1519
36,Chr1,28359916,28359959,28359938,43
36,Chr1,30210393,30210501,30210447,108
36,Chr2,8840569,8842190,8841379,1621
36,Chr2,9460126,9460283,9460204,157
36,Chr2,11110087,11110189,11110138,102
36,Chr2,14885533,14886914,14886223,1381
36,Chr2,17516501,17517658,17517079,1157
36,Chr2,18605489,18606226,18605857,737
36,Chr3,520421,520843,520632,422
36,Chr3,1038840,1047396,1043118,8556
36,Chr3,2751737,2752206,2751971,469
36,Chr3,5483622,5483820,5483721,198
36,Chr3,6800827,6802517,6801672,1690
36,Chr3,19136205,19136540,19136373,335
36,Chr3,22164367,22164425,22164396,58
36,Chr3,23119887,23120487,23120187,600
36,Chr4,136301,136363,136332,62
36,Chr4,307756,308062,307909,306
36,Chr4,8539316,8539384,8539350,68
36,Chr4,10058293,10058777,10058535,484
36,Chr4,11247962,11248266,11248114,304
36,Chr5,303424,304476,303950,1052
36,Chr5,4089739,4091185,4090462,1446
36,Chr5,5866930,5867199,5867064,269
36,Chr5,17684006,17686833,17685420,2827
36,Chr5,21593925,21598863,21596394,4938
36,Chr5,23944880,23946004,23945442,1124
36,Chr5,25645105,25645467,25645286,362
37,Chr1,1963020,1964020,1963520,1000
37,Chr1,3047428,3047732,3047580,304
37,Chr1,4193460,4194580,4194020,1120
37,Chr1,4979083,4980034,4979559,951
37,Chr1,6860919,6862064,6861491,1145
37,Chr1,7777957,7780266,7779111,2309
37,Chr1,12367292,12367589,12367440,297
37,Chr1,21058758,21059587,21059172,829
37,Chr1,26746175,26746990,26746583,815
37,Chr1,27302676,27302679,27302678,3
37,Chr1,29780387,29781648,29781017,1261
37,Chr2,328998,331154,330076,2156
37,Chr2,1933781,1933862,1933821,81
37,Chr2,9540969,9541253,9541111,284
37,Chr2,11376979,11376997,11376988,18
37,Chr2,12002771,12005391,12004081,2620
37,Chr2,16490579,16491208,16490893,629
37,Chr3,2038961,2040731,2039846,1770
37,Chr3,5333204,5334473,5333838,1269
37,Chr3,7541231,7543437,7542334,2206
37,Chr3,7807885,7808524,7808205,639
37,Chr3,9218378,9218429,9218404,51
37,Chr3,17223673,17223810,17223741,137
37,Chr3,17859537,17859976,17859757,439
37,Chr3,19481099,19481307,19481203,208
37,Chr3,19962856,19964076,19963466,1220
37,Chr4,7802219,7802436,7802327,217
37,Chr4,9876395,9878536,9877465,2141
37,Chr4,12777145,12780036,12778591,2891
37,Chr4,13856802,13857009,13856906,207
37,Chr4,14025388,14026575,14025982,1187
37,Chr4,18328336,18332236,18330286,3900
37,Chr5,5027768,5027941,5027854,173
37,Chr5,6015822,6016130,6015976,308
37,Chr5,6424418,6424960,6424689,542
37,Chr5,13884140,13884274,13884207,134
37,Chr5,26873215,26873287,26873251,72
38,Chr1,1641504,1644172,1642838,2668
38,Chr1,5054681,5070376,5062529,15695
38,Chr1,8099446,8100524,8099985,1078
38,Chr1,8993661,8993680,8993671,19
38,Chr1,20335559,20342252,20338905,6693
38,Chr1,22218427,22218698,22218563,271
38,Chr1,28157752,28159724,28158738,1972
38,Chr2,9525997,9530265,9528131,4268
38,Chr2,12994850,12995384,12995117,534
38,Chr2,14159547,14159855,14159701,308
38,Chr2,15274186,15274831,15274508,645
38,Chr2,16108784,16112100,16110442,3316
38,Chr3,1793619,1793677,1793648,58
38,Chr3,5707383,5707488,5707435,105
38,Chr3,6616262,6619900,6618081,3638
38,Chr3,10205889,10205946,10205917,57
38,Chr4,18544907,18545523,18545215,616
38,Chr5,4898121,4898783,4898452,662
38,Chr5,5764576,5765705,5765140,1129
38,Chr5,6747072,6751553,6749312,4481
38,Chr5,10264320,10264946,10264633,626
38,Chr5,14065190,14065241,14065216,51
38,Chr5,25085545,25086083,25085814,538
38,Chr5,25556257,25559811,25558034,3554
39,Chr1,210850,266254,238552,55404
39,Chr1,2205974,2208201,2207088,2227
39,Chr1,9454815,9456960,9455887,2145
39,Chr1,28760401,28826609,28793505,66208
39,Chr2,11280666,11281086,11280876,420
39,Chr2,15337470,15338090,15337780,620
39,Chr3,4847048,4848741,4847894,1693
39,Chr3,10304686,10306909,10305798,2223
39,Chr3,15929639,15930000,15929819,361
39,Chr3,19748545,19749859,19749202,1314
39,Chr4,647305,650792,649049,3487
39,Chr5,1917646,1917668,1917657,22
39,Chr5,4268971,4270331,4269651,1360
39,Chr5,13872512,13872834,13872673,322
39,Chr5,22210401,22212489,22211445,2088
39,Chr5,22709150,22713072,22711111,3922
4,Chr1,1282314,1382716,1332515,100402
4,Chr1,2336216,2336312,2336264,96
4,Chr1,3930271,3930488,3930379,217
4,Chr1,5634043,5637523,5635783,3480
4,Chr1,6885300,6885664,6885482,364
4,Chr1,8137292,8137878,8137585,586
4,Chr1,8351146,8352519,8351832,1373
4,Chr1,17211863,17212076,17211969,213
4,Chr1,18196541,18196812,18196677,271
4,Chr1,21021080,21022555,21021818,1475
4,Chr1,24917120,24917376,24917248,256
4,Chr1,25511836,25531005,25521420,19169
4,Chr1,25912006,25913851,25912928,1845
4,Chr1,28174240,28175560,28174900,1320
4,Chr1,28615643,28617115,28616379,1472
4,Chr1,30270745,30270974,30270859,229
4,Chr2,1991873,1992080,1991977,207
4,Chr2,6308851,6309098,6308975,247
4,Chr2,8673082,8675154,8674118,2072
4,Chr2,10105258,10105433,10105346,175
4,Chr2,12014757,12017260,12016009,2503
4,Chr2,14426243,14426540,14426391,297
4,Chr2,17115421,17118282,17116851,2861
4,Chr2,17848035,17848787,17848411,752
4,Chr2,18072331,18072858,18072595,527
4,Chr2,19479831,19483106,19481469,3275
4,Chr3,26138,27414,26776,1276
4,Chr3,947345,949727,948536,2382
4,Chr3,975518,975698,975608,180
4,Chr3,1648982,1653409,1651196,4427
4,Chr3,2257141,2257586,2257363,445
4,Chr3,3663622,3664178,3663900,556
4,Chr3,5418342,5418902,5418622,560
4,Chr3,6970532,6986764,6978648,16232
4,Chr3,18208642,18208895,18208768,253
4,Chr3,19991562,19992725,19992144,1163
4,Chr3,20301118,20301465,20301292,347
4,Chr3,21836347,21838230,21837289,1883
4,Chr3,22211816,22212573,22212194,757
4,Chr3,22835558,22842900,22839229,7342
4,Chr4,89476,89873,89674,397
4,Chr4,6370440,6370798,6370619,358
4,Chr4,6817855,6819258,6818557,1403
4,Chr4,8165393,8166447,8165920,1054
4,Chr4,11862501,11863603,11863052,1102
4,Chr4,12774893,12776820,12775857,1927
4,Chr4,13925062,13929547,13927304,4485
4,Chr4,13966673,13967553,13967113,880
4,Chr5,269658,270140,269899,482
4,Chr5,1493747,1495198,1494473,1451
4,Chr5,2278030,2278975,2278502,945
4,Chr5,2556364,2557196,2556780,832
4,Chr5,3387131,3387873,3387502,742
4,Chr5,6988685,6990852,6989769,2167
4,Chr5,7500707,7505495,7503101,4788
4,Chr5,8600801,8600997,8600899,196
4,Chr5,18718892,18720366,18719629,1474
4,Chr5,20070931,20072487,20071709,1556
4,Chr5,20557341,20557463,20557402,122
4,Chr5,21611277,21612533,21611905,1256
4,Chr5,25665927,25666181,25666054,254
40,Chr1,5152237,5153499,5152868,1262
40,Chr1,8377439,8377762,8377601,323
40,Chr1,19007704,19007991,19007848,287
40,Chr1,19908093,19908293,19908193,200
40,Chr1,20687469,20687849,20687659,380
40,Chr1,29429932,29430257,29430094,325
40,Chr2,250292,250560,250426,268
40,Chr2,12998958,12999828,12999393,870
40,Chr2,15759188,15764167,15761678,4979
40,Chr2,18154466,18169172,18161819,14706
40,Chr3,2952858,2953355,2953106,497
40,Chr3,17588292,17590139,17589216,1847
40,Chr4,8384343,8384660,8384501,317
40,Chr4,11184451,11187058,11185755,2607
40,Chr4,12009475,12012603,12011039,3128
40,Chr5,21645830,21647135,21646482,1305
40,Chr5,25179582,25180290,25179936,708
41,Chr1,6641514,6642102,6641808,588
41,Chr1,14010671,15983742,14997207,1973071
41,Chr1,18219990,18220602,18220296,612
41,Chr1,20602113,20602978,20602545,865
41,Chr1,21046632,21052089,21049360,5457
41,Chr1,24646201,24646511,24646356,310
41,Chr2,1490976,1491084,1491030,108
41,Chr2,8568698,8569906,8569302,1208
41,Chr2,10662989,10663592,10663291,603
41,Chr2,13340644,13340877,13340760,233
41,Chr2,15106681,15107931,15107306,1250
41,Chr2,18559726,18563894,18561810,4168
41,Chr3,104414,105607,105010,1193
41,Chr3,2723740,2726989,2725364,3249
41,Chr3,4674216,4674669,4674442,453
41,Chr3,23120487,23132471,23126479,11984
41,Chr4,12012603,12013704,12013153,1101
41,Chr4,13289288,13289445,13289366,157
41,Chr5,310062,310449,310256,387
41,Chr5,1156108,1157906,1157007,1798
41,Chr5,1740854,1741385,1741120,531
41,Chr5,4115552,4116171,4115862,619
41,Chr5,7757881,7758261,7758071,380
41,Chr5,19618336,19618590,19618463,254
41,Chr5,21780372,21780950,21780661,578
41,Chr5,23388881,23388986,23388933,105
41,Chr5,25146314,25146430,25146372,116
41,Chr5,26747908,26748301,26748104,393
42,Chr1,157407,158640,158023,1233
42,Chr1,618452,623047,620750,4595
42,Chr1,3910050,3910416,3910233,366
42,Chr1,9864368,9864764,9864566,396
42,Chr1,25724742,25726065,25725404,1323
42,Chr1,30278172,30278753,30278462,581
42,Chr2,14849575,14850517,14850046,942
42,Chr2,15981288,15981588,15981438,300
42,Chr2,16645503,16645983,16645743,480
42,Chr2,17379283,17379476,17379379,193
42,Chr3,2697544,2698761,2698152,1217
42,Chr3,19553492,19555252,19554372,1760
42,Chr3,21016922,21017582,21017252,660
42,Chr3,21500370,21513104,21506737,12734
42,Chr4,476264,478305,477284,2041
42,Chr4,1069457,1070636,1070047,1179
42,Chr4,12682341,12685606,12683973,3265
42,Chr4,14393164,14393453,14393308,289
42,Chr5,2960892,2961808,2961350,916
42,Chr5,18638467,18639121,18638794,654
43,Chr1,4246522,4249323,4247922,2801
43,Chr1,6975620,6976899,6976260,1279
43,Chr1,11755200,11758556,11756878,3356
43,Chr1,19879296,19879711,19879504,415
43,Chr1,20598749,20598858,20598803,109
43,Chr1,23780339,23782650,23781495,2311
43,Chr1,26302051,26302567,26302309,516
43,Chr1,26940011,26943012,26941511,3001
43,Chr1,28281976,28284740,28283358,2764
43,Chr1,28739401,28745359,28742380,5958
43,Chr1,29504967,29506527,29505747,1560
43,Chr1,29852973,29853643,29853308,670
43,Chr2,6795275,6795431,6795353,156
43,Chr2,12469846,12471348,12470597,1502
43,Chr2,16701181,16702844,16702013,1663
43,Chr2,18410185,18410957,18410571,772
43,Chr2,18878836,18879316,18879076,480
43,Chr3,83531,84250,83891,719
43,Chr3,425629,425686,425657,57
43,Chr3,1837786,1838148,1837967,362
43,Chr3,18801168,18802435,18801802,1267
43,Chr3,20367127,20367593,20367360,466
43,Chr3,21894044,21894412,21894228,368
43,Chr4,15839640,15841184,15840412,1544
43,Chr4,17303775,17305959,17304867,2184
43,Chr4,18252525,18254444,18253485,1919
43,Chr5,671559,672424,671991,865
43,Chr5,2098968,2099013,2098990,45
43,Chr5,3471529,3472208,3471869,679
43,Chr5,3613652,3614388,3614020,736
43,Chr5,4346549,4347881,4347215,1332
43,Chr5,4923193,4929002,4926097,5809
43,Chr5,5833030,5833749,5833390,719
43,Chr5,6401760,6402237,6401998,477
43,Chr5,9719116,9719301,9719208,185
43,Chr5,13866410,13866710,13866560,300
43,Chr5,17990410,17990767,17990588,357
43,Chr5,19172050,19174557,19173304,2507
43,Chr5,21751487,21763740,21757613,12253
43,Chr5,23069438,23070246,23069842,808
43,Chr5,24132379,24132719,24132549,340
43,Chr5,24621539,24622147,24621843,608
43,Chr5,25251539,25252068,25251803,529
43,Chr5,26110817,26111430,26111123,613
44,Chr1,2089031,2090061,2089546,1030
44,Chr1,7672839,7674749,7673794,1910
44,Chr1,12021852,12022387,12022120,535
44,Chr1,13001537,13006264,13003901,4727
44,Chr1,19955245,19963286,19959265,8041
44,Chr1,28671057,28678743,28674900,7686
44,Chr2,1142762,1143355,1143058,593
44,Chr2,18136280,18138389,18137334,2109
44,Chr2,19333109,19334555,19333832,1446
44,Chr3,2042983,2045603,2044293,2620
44,Chr3,2340666,2341347,2341006,681
44,Chr3,4319729,4330506,4325117,10777
44,Chr3,21059701,21060983,21060342,1282
44,Chr3,22794359,22794519,22794439,160
44,Chr3,23316584,23317858,23317221,1274
44,Chr4,8393184,8393263,8393224,79
44,Chr4,13592427,13612527,13602477,20100
44,Chr5,22246876,22248566,22247721,1690
44,Chr5,23708567,23709398,23708983,831
44,Chr5,25891341,25893725,25892533,2384
44,Chr5,26852289,26852854,26852571,565
45,Chr1,3321865,3323366,3322615,1501
45,Chr1,3833068,3834348,3833708,1280
45,Chr1,6463142,6463686,6463414,544
45,Chr1,7016862,7017501,7017182,639
45,Chr1,9463710,9472228,9467969,8518
45,Chr1,10573993,10574632,10574313,639
45,Chr1,24149899,24151352,24150625,1453
45,Chr1,28785980,28822688,28804334,36708
45,Chr2,8902680,8903048,8902864,368
45,Chr2,11580828,11581554,11581191,726
45,Chr2,12236438,12238754,12237596,2316
45,Chr2,13310827,13311063,13310945,236
45,Chr2,16383851,16387413,16385632,3562
45,Chr2,18340962,18341054,18341008,92
45,Chr3,186923,187418,187171,495
45,Chr3,1386157,1386425,1386291,268
45,Chr3,6174146,6174503,6174324,357
45,Chr3,6750702,6751405,6751054,703
45,Chr3,7582516,7582931,7582724,415
45,Chr3,9456597,9458204,9457401,1607
45,Chr3,10075343,10076024,10075683,681
45,Chr3,10662983,10663842,10663413,859
45,Chr3,18343175,18343815,18343495,640
45,Chr3,19159435,19162282,19160859,2847
45,Chr3,19780127,19782973,19781550,2846
45,Chr3,20296794,20297403,20297098,609
45,Chr4,946521,947320,946921,799
45,Chr4,8125250,8126261,8125756,1011
45,Chr4,11395063,11399326,11397195,4263
45,Chr4,13001265,13001910,13001587,645
45,Chr5,3399139,3399367,3399253,228
45,Chr5,8359006,8360127,8359566,1121
45,Chr5,16238561,16239625,16239093,1064
45,Chr5,17349084,17349169,17349126,85
45,Chr5,19816684,19819713,19818198,3029
45,Chr5,22174106,22174141,22174124,35
45,Chr5,24768025,24768165,24768095,140
46,Chr1,562860,563367,563114,507
46,Chr1,11470992,11471209,11471100,217
46,Chr1,20449800,20456719,20453260,6919
46,Chr1,25184483,25185208,25184845,725
46,Chr1,28022247,28022911,28022579,664
46,Chr2,15739846,15747720,15743783,7874
46,Chr3,4485524,4487600,4486562,2076
46,Chr3,6226190,6226819,6226504,629
46,Chr3,7259730,7263805,7261768,4075
46,Chr3,9591753,9591873,9591813,120
46,Chr3,17564373,17564455,17564414,82
46,Chr3,18057260,18057329,18057294,69
46,Chr3,22248470,22254325,22251398,5855
46,Chr4,6841201,6845098,6843149,3897
46,Chr4,8438806,8438956,8438881,150
46,Chr4,11641065,11642402,11641733,1337
46,Chr4,13673351,13674650,13674001,1299
46,Chr5,174865,175908,175387,1043
46,Chr5,2208290,2208704,2208497,414
46,Chr5,3130900,3132450,3131675,1550
46,Chr5,5694335,5694409,5694372,74
46,Chr5,6756813,6757166,6756989,353
46,Chr5,26391181,26391716,26391449,535
46,Chr5,26952557,26952651,26952604,94
47,Chr1,2852039,2857210,2854625,5171
47,Chr1,6622215,6623991,6623103,1776
47,Chr1,7654035,7659356,7656695,5321
47,Chr1,20777176,20777352,20777264,176
47,Chr1,22773943,22774073,22774008,130
47,Chr1,24789155,24790260,24789707,1105
47,Chr1,25657059,25658587,25657823,1528
47,Chr1,29308711,29308850,29308781,139
47,Chr2,1051416,1052729,1052072,1313
47,Chr2,6801071,6801370,6801221,299
47,Chr2,8429163,8430413,8429788,1250
47,Chr2,11481953,11482967,11482460,1014
47,Chr2,17547569,17549608,17548589,2039
47,Chr2,19109129,19111278,19110203,2149
47,Chr3,89661,89668,89665,7
47,Chr3,516779,520843,518811,4064
47,Chr3,933272,939116,936194,5844
47,Chr3,5094367,5124565,5109466,30198
47,Chr3,7523944,7526831,7525388,2887
47,Chr3,18876793,18877176,18876985,383
47,Chr3,19371728,19374896,19373312,3168
47,Chr3,22499765,22500195,22499980,430
47,Chr4,5158372,5158830,5158601,458
47,Chr4,5708809,5708974,5708891,165
47,Chr4,8491603,8492828,8492215,1225
47,Chr4,11351824,11352155,11351990,331
47,Chr4,18124530,18124734,18124632,204
47,Chr5,533716,533787,533752,71
47,Chr5,1740854,1741385,1741120,531
47,Chr5,2864625,2874908,2869767,10283
47,Chr5,3811043,3811543,3811293,500
47,Chr5,6034324,6034523,6034424,199
47,Chr5,6850833,6852188,6851511,1355
47,Chr5,16056892,16057260,16057076,368
47,Chr5,21056128,21056309,21056218,181
47,Chr5,22724170,22728104,22726137,3934
47,Chr5,24252206,24252309,24252258,103
48,Chr1,266733,266846,266789,113
48,Chr1,1893881,1894008,1893945,127
48,Chr1,2390279,2390309,2390294,30
48,Chr1,4337681,4339842,4338761,2161
48,Chr1,7238927,7239403,7239165,476
48,Chr1,9429452,9429519,9429486,67
48,Chr1,10678349,10678526,10678437,177
48,Chr1,12222499,12224729,12223614,2230
48,Chr1,13077389,13077492,13077441,103
48,Chr1,17252565,17252626,17252595,61
48,Chr1,22075921,22076657,22076289,736
48,Chr1,24498311,24498614,24498463,303
48,Chr1,26415995,26416518,26416257,523
48,Chr1,28562122,28564936,28563529,2814
48,Chr1,30268389,30269146,30268767,757
48,Chr2,1725191,1726752,1725971,1561
48,Chr2,8098399,8098493,8098446,94
48,Chr2,9752535,9752795,9752665,260
48,Chr2,10395040,10395198,10395119,158
48,Chr2,10856819,10856886,10856853,67
48,Chr2,12780075,12781474,12780775,1399
48,Chr2,16679962,16682528,16681245,2566
48,Chr2,17586430,17588932,17587681,2502
48,Chr3,294503,296515,295509,2012
48,Chr3,812267,812690,812479,423
48,Chr3,2510465,2512365,2511415,1900
48,Chr3,3284381,3290911,3287646,6530
48,Chr3,6097310,6098399,6097854,1089
48,Chr3,6567387,6567732,6567559,345
48,Chr3,21654731,21656386,21655559,1655
48,Chr4,647292,647296,647294,4
48,Chr4,759902,766605,763254,6703
48,Chr4,6458375,6459715,6459045,1340
48,Chr4,6851439,6853472,6852455,2033
48,Chr4,7308343,7308349,7308346,6
48,Chr4,8333274,8334971,8334122,1697
48,Chr4,11955025,11955827,11955426,802
48,Chr4,13722184,13723073,13722628,889
48,Chr4,17987640,17990195,17988918,2555
48,Chr5,3958438,3981941,3970190,23503
48,Chr5,5618870,5620586,5619728,1716
48,Chr5,6401225,6401703,6401464,478
48,Chr5,8026126,8026616,8026371,490
48,Chr5,13740065,13749867,13744966,9802
48,Chr5,17190953,17191008,17190981,55
48,Chr5,17750663,17752163,17751413,1500
49,Chr1,2679553,2684066,2681809,4513
49,Chr1,4273900,4275011,4274456,1111
49,Chr1,6959223,6962410,6960817,3187
49,Chr1,9448345,9453140,9450743,4795
49,Chr1,17370594,17371634,17371114,1040
49,Chr1,21886882,21887740,21887311,858
49,Chr2,869011,869793,869402,782
49,Chr2,8282067,8292448,8287257,10381
49,Chr2,10083953,10084593,10084273,640
49,Chr2,12628859,12629582,12629221,723
49,Chr2,14001652,14002787,14002220,1135
49,Chr2,15111284,15111596,15111440,312
49,Chr2,16843054,16843746,16843400,692
49,Chr3,1033000,1036006,1034503,3006
49,Chr3,6085852,6086496,6086174,644
49,Chr3,9710819,9711363,9711091,544
49,Chr3,16219172,16227545,16223358,8373
49,Chr3,17888401,17889326,17888863,925
49,Chr3,19648925,19649140,19649033,215
49,Chr3,21578115,21583952,21581033,5837
49,Chr4,171714,173028,172371,1314
49,Chr4,1304369,1304461,1304415,92
49,Chr4,10969901,10969985,10969943,84
49,Chr4,11946600,11946695,11946648,95
49,Chr4,13974895,13975127,13975011,232
49,Chr4,14835576,14838555,14837066,2979
49,Chr4,16874587,16878040,16876313,3453
49,Chr5,2608045,2609253,2608649,1208
49,Chr5,4611344,4613875,4612610,2531
49,Chr5,7953109,7953200,7953155,91
49,Chr5,23299755,23300068,23299911,313
49,Chr5,25023381,25025728,25024555,2347
49,Chr5,26580306,26580622,26580464,316
5,Chr1,210850,266254,238552,55404
5,Chr1,8863343,8863706,8863525,363
5,Chr1,9698514,9701155,9699834,2641
5,Chr1,10547236,10547553,10547394,317
5,Chr1,18753519,18754508,18754013,989
5,Chr1,25279937,25281872,25280905,1935
5,Chr1,30332332,30333965,30333148,1633
5,Chr2,13840701,13842763,13841732,2062
5,Chr2,17814036,17818369,17816202,4333
5,Chr3,5165948,5182864,5174406,16916
5,Chr3,10356286,10356299,10356292,13
5,Chr3,18972942,18974761,18973852,1819
5,Chr3,19937792,19938595,19938194,803
5,Chr5,158429,158608,158519,179
5,Chr5,2861682,2864625,2863154,2943
5,Chr5,25068973,25069901,25069437,928
50,Chr1,1851288,1851382,1851335,94
50,Chr1,4782078,4783252,4782665,1174
50,Chr1,7526346,7526798,7526572,452
50,Chr1,7659914,7660055,7659984,141
50,Chr1,8177890,8178003,8177946,113
50,Chr1,10841461,10845300,10843381,3839
50,Chr1,28742704,28745359,28744032,2655
50,Chr2,10445249,10446137,10445693,888
50,Chr2,14880929,14884716,14882823,3787
50,Chr2,19467282,19467401,19467342,119
50,Chr3,3000020,3013021,3006520,13001
50,Chr3,11606623,11606654,11606639,31
50,Chr4,13510822,13512245,13511534,1423
50,Chr5,343440,344364,343902,924
50,Chr5,1444591,1447030,1445811,2439
50,Chr5,3070749,3071064,3070907,315
50,Chr5,4830712,4832619,4831666,1907
50,Chr5,6595966,6597071,6596518,1105
50,Chr5,7932446,7933094,7932770,648
50,Chr5,9850802,9851526,9851164,724
51,Chr1,834960,844413,839686,9453
51,Chr1,4610834,4611107,4610970,273
51,Chr1,6393214,6393441,6393328,227
51,Chr1,9801918,9802374,9802146,456
51,Chr1,10626595,10626896,10626745,301
51,Chr1,30370650,30370992,30370821,342
51,Chr2,369164,378561,373862,9397
51,Chr2,7627299,7629260,7628279,1961
51,Chr2,12757869,12759033,12758451,1164
51,Chr2,13811888,13812117,13812002,229
51,Chr2,19460557,19467282,19463919,6725
51,Chr3,163598,164137,163868,539
51,Chr3,637974,638483,638228,509
51,Chr3,1054190,1055555,1054872,1365
51,Chr3,2677397,2679833,2678615,2436
51,Chr3,3506755,3506849,3506802,94
51,Chr3,4444826,4452589,4448708,7763
51,Chr3,6465144,6465778,6465461,634
51,Chr3,17588292,17590139,17589216,1847
51,Chr3,19295659,19299801,19297730,4142
51,Chr4,5170173,5170588,5170381,415
51,Chr4,6207835,6208208,6208021,373
51,Chr4,7420517,7420841,7420679,324
51,Chr4,8391544,8393184,8392364,1640
51,Chr4,8448429,8448700,8448565,271
51,Chr4,9948681,9949468,9949075,787
51,Chr4,10896792,10897967,10897380,1175
51,Chr4,18284221,18284852,18284537,631
51,Chr5,1087113,1088147,1087630,1034
51,Chr5,8334209,8334949,8334579,740
51,Chr5,21548938,21549009,21548974,71
51,Chr5,22094158,22100357,22097258,6199
51,Chr5,24923905,24924477,24924191,572
51,Chr5,25695680,25696914,25696297,1234
52,Chr1,792084,797322,794703,5238
52,Chr1,3031852,3032106,3031979,254
52,Chr1,19648470,19648878,19648674,408
52,Chr1,22166472,22166883,22166678,411
52,Chr1,28179141,28180936,28180039,1795
52,Chr2,348029,348823,348426,794
52,Chr2,5921997,5922188,5922093,191
52,Chr2,14424202,14425451,14424826,1249
52,Chr2,17369922,17371235,17370578,1313
52,Chr2,18873394,18874851,18874122,1457
52,Chr2,19545441,19546670,19546055,1229
52,Chr3,791391,791764,791577,373
52,Chr3,4089699,4091586,4090643,1887
52,Chr3,6536028,6567142,6551585,31114
52,Chr3,8768022,8768826,8768424,804
52,Chr3,9173910,9173965,9173938,55
52,Chr3,21702228,21703030,21702629,802
52,Chr4,6786168,6786403,6786286,235
52,Chr4,12365692,12366019,12365856,327
52,Chr4,13047618,13055020,13051319,7402
52,Chr5,1742494,1750107,1746300,7613
52,Chr5,3289640,3290044,3289842,404
52,Chr5,7892363,7892488,7892425,125
52,Chr5,16735358,16736148,16735753,790
52,Chr5,18712111,18712491,18712301,380
52,Chr5,26004541,26004765,26004653,224
52,Chr5,26238856,26239458,26239157,602
53,Chr1,210850,266254,238552,55404
53,Chr1,4269017,4270950,4269983,1933
53,Chr1,5643755,5645258,5644507,1503
53,Chr1,18436137,18436381,18436259,244
53,Chr1,21040574,21044568,21042571,3994
53,Chr2,10367886,10368424,10368155,538
53,Chr2,12361056,12362096,12361576,1040
53,Chr2,13091490,13092456,13091973,966
53,Chr2,17807758,17814036,17810897,6278
53,Chr3,163598,164137,163868,539
53,Chr3,254002,255349,254676,1347
53,Chr3,9775630,9775932,9775781,302
53,Chr3,11744818,11744888,11744853,70
53,Chr3,21413314,21435092,21424203,21778
53,Chr5,954847,955415,955131,568
53,Chr5,5901092,5901845,5901468,753
53,Chr5,16468238,16468770,16468504,532
53,Chr5,18520256,18524719,18522488,4463
53,Chr5,21337061,21338442,21337751,1381
54,Chr1,1207631,1207742,1207687,111
54,Chr1,8177912,8178003,8177958,91
54,Chr1,27092518,27092906,27092712,388
54,Chr1,27938277,27938492,27938385,215
54,Chr1,29276349,29308227,29292288,31878
54,Chr2,5835634,5835811,5835722,177
54,Chr2,7664340,7665345,7664842,1005
54,Chr2,16971862,16972574,16972218,712
54,Chr2,18913868,18914290,18914079,422
54,Chr3,3694411,3694423,3694417,12
54,Chr3,5371646,5372409,5372028,763
54,Chr3,7387083,7388267,7387675,1184
54,Chr3,17261305,17261960,17261633,655
54,Chr3,19748545,19749859,19749202,1314
54,Chr3,21982664,21982835,21982750,171
54,Chr4,1174173,1174782,1174477,609
54,Chr4,8667627,8668944,8668285,1317
54,Chr5,40726,41563,41144,837
54,Chr5,735698,735900,735799,202
54,Chr5,1282919,1283057,1282988,138
54,Chr5,1933196,1933404,1933300,208
54,Chr5,3258225,3258465,3258345,240
54,Chr5,6162486,6163901,6163194,1415
54,Chr5,19793915,19794548,19794231,633
54,Chr5,23692632,23694079,23693356,1447
54,Chr5,26128442,26128552,26128497,110
55,Chr1,3020738,3021009,3020874,271
55,Chr1,4966392,4967219,4966806,827
55,Chr1,8230298,8232155,8231226,1857
55,Chr1,9261289,9276879,9269084,15590
55,Chr1,13168717,13168951,13168834,234
55,Chr1,27149048,27150030,27149539,982
55,Chr1,28642136,28651893,28647014,9757
55,Chr1,28651893,28724228,28688061,72335
55,Chr1,29337106,29337186,29337146,80
55,Chr2,1161197,1161234,1161215,37
55,Chr2,8567408,8567496,8567452,88
55,Chr2,9213651,9214493,9214072,842
55,Chr2,10757217,10758273,10757745,1056
55,Chr2,11955974,11958488,11957231,2514
55,Chr2,13137936,13141824,13139880,3888
55,Chr2,14210981,14215050,14213015,4069
55,Chr2,16857140,16857437,16857288,297
55,Chr2,18174768,18177528,18176148,2760
55,Chr3,1398109,1398142,1398125,33
55,Chr3,3730322,3731809,3731066,1487
55,Chr3,7642922,7643962,7643442,1040
55,Chr3,9346716,9347051,9346884,335
55,Chr3,16890875,16891214,16891045,339
55,Chr3,18761082,18762380,18761731,1298
55,Chr3,19624169,19624397,19624283,228
55,Chr3,23278008,23278463,23278236,455
55,Chr4,12473799,12474273,12474036,474
55,Chr5,339721,340360,340041,639
55,Chr5,7135595,7135658,7135627,63
55,Chr5,7223822,7224006,7223914,184
55,Chr5,8265739,8265957,8265848,218
55,Chr5,21817943,21819258,21818601,1315
55,Chr5,22358233,22358987,22358610,754
55,Chr5,22768255,22768398,22768327,143
55,Chr5,25228062,25230302,25229182,2240
55,Chr5,26174853,26175231,26175042,378
56,Chr1,384704,387224,385964,2520
56,Chr1,3116880,3121154,3119017,4274
56,Chr1,4649385,4650334,4649859,949
56,Chr1,6883276,6885199,6884238,1923
56,Chr1,9462249,9463631,9462940,1382
56,Chr1,10888194,10888988,10888591,794
56,Chr1,26143168,26143440,26143304,272
56,Chr1,26771406,26773025,26772216,1619
56,Chr2,15006207,15007551,15006879,1344
56,Chr2,18536106,18536921,18536514,815
56,Chr3,116833,120693,118763,3860
56,Chr3,927954,928207,928080,253
56,Chr3,3594726,3595414,3595070,688
56,Chr3,6164355,6164430,6164393,75
56,Chr3,6709958,6713521,6711740,3563
56,Chr3,21706682,21706972,21706827,290
56,Chr4,12621706,12621996,12621851,290
56,Chr5,3031932,3044373,3038152,12441
56,Chr5,7180439,7180850,7180645,411
56,Chr5,20699318,20699972,20699645,654
56,Chr5,22434462,22436278,22435370,1816
56,Chr5,23119076,23144398,23131737,25322
56,Chr5,24771105,24771281,24771193,176
56,Chr5,26911906,26912269,26912088,363
57,Chr1,1176980,1177912,1177446,932
57,Chr1,6662604,6663295,6662950,691
57,Chr1,7443207,7445310,7444259,2103
57,Chr1,27467089,27468843,27467966,1754
57,Chr1,29560808,29561250,29561029,442
57,Chr2,19048343,19050712,19049527,2369
57,Chr3,2240493,2240668,2240581,175
57,Chr3,21305733,21307046,21306389,1313
57,Chr3,21583952,21591581,21587766,7629
57,Chr4,1379301,1379708,1379505,407
57,Chr4,18332552,18336724,18334638,4172
57,Chr5,2170064,2170897,2170480,833
57,Chr5,5514403,5514404,5514403,1
57,Chr5,8227246,8227430,8227338,184
57,Chr5,14916605,14918533,14917569,1928
57,Chr5,20776771,20777069,20776920,298
57,Chr5,22932622,22932743,22932682,121
58,Chr1,706920,708523,707722,1603
58,Chr1,772458,772724,772591,266
58,Chr1,1423645,1423727,1423686,82
58,Chr1,8268306,8268373,8268340,67
58,Chr1,12549846,12553676,12551761,3830
58,Chr1,26376744,26377930,26377337,1186
58,Chr1,30247300,30248691,30247996,1391
58,Chr2,7740087,7740664,7740375,577
58,Chr2,9495319,9495876,9495597,557
58,Chr2,10105433,10106066,10105749,633
58,Chr2,11001897,11010953,11006425,9056
58,Chr2,14542614,14543100,14542857,486
58,Chr2,17146658,17147326,17146992,668
58,Chr3,2310418,2312158,2311288,1740
58,Chr3,4056808,4061099,4058954,4291
58,Chr3,4605030,4605530,4605280,500
58,Chr3,5066593,5066762,5066677,169
58,Chr3,5334445,5334473,5334459,28
58,Chr3,5858037,5859313,5858675,1276
58,Chr3,8560852,8561434,8561143,582
58,Chr3,17948091,17948710,17948401,619
58,Chr3,18758531,18758913,18758722,382
58,Chr3,20649281,20649291,20649286,10
58,Chr3,21468762,21492444,21480603,23682
58,Chr3,23290413,23291586,23290999,1173
58,Chr4,13781526,13793924,13787725,12398
58,Chr5,97633,98195,97914,562
58,Chr5,1709445,1709791,1709618,346
58,Chr5,6339283,6339487,6339385,204
58,Chr5,8879196,8882198,8880697,3002
58,Chr5,23175151,23214138,23194645,38987
59,Chr1,2139615,2141179,2140397,1564
59,Chr1,6075704,6075782,6075743,78
59,Chr1,7823204,7823843,7823524,639
59,Chr1,8535384,8535425,8535404,41
59,Chr1,17353421,17353529,17353475,108
59,Chr1,24435991,24437479,24436735,1488
59,Chr1,29488283,29488449,29488366,166
59,Chr2,800396,800847,800622,451
59,Chr2,10350726,10351048,10350887,322
59,Chr2,13573581,13574560,13574071,979
59,Chr2,15297052,15297872,15297462,820
59,Chr2,17154570,17158433,17156502,3863
59,Chr3,1981385,1981885,1981635,500
59,Chr3,2464533,2465821,2465177,1288
59,Chr3,8586408,8589246,8587827,2838
59,Chr4,1539210,1539388,1539299,178
59,Chr4,7791782,7794497,7793140,2715
59,Chr4,8202616,8203763,8203190,1147
59,Chr4,12264333,12264445,12264389,112
59,Chr4,15666861,15670561,15668711,3700
59,Chr4,17998829,17998858,17998843,29
59,Chr5,2443308,2443347,2443328,39
59,Chr5,3071250,3072460,3071855,1210
59,Chr5,5765705,5765845,5765775,140
59,Chr5,9219662,9220041,9219852,379
59,Chr5,14239651,14240145,14239898,494
59,Chr5,18706367,18707304,18706835,937
59,Chr5,22739695,22746687,22743191,6992
59,Chr5,24612473,24613811,24613142,1338
59,Chr5,25234938,25236920,25235929,1982
59,Chr5,26265653,26266032,26265843,379
6,Chr1,584728,585101,584914,373
6,Chr1,1543916,1544180,1544048,264
6,Chr1,2069359,2078474,2073917,9115
6,Chr1,2808268,2809650,2808959,1382
6,Chr1,7704631,7705248,7704939,617
6,Chr1,8725524,8727332,8726428,1808
6,Chr1,11925561,11929076,11927319,3515
6,Chr1,20780366,20781077,20780722,711
6,Chr1,21024097,21024200,21024149,103
6,Chr1,30308142,30309974,30309058,1832
6,Chr2,7578172,7578294,7578233,122
6,Chr2,10559326,10559592,10559459,266
6,Chr2,11513435,11514094,11513765,659
6,Chr2,13179075,13179887,13179481,812
6,Chr2,14481724,14481740,14481732,16
6,Chr2,18440489,18441388,18440939,899
6,Chr3,18546070,18546575,18546322,505
6,Chr3,19234220,19236822,19235521,2602
6,Chr3,21262848,21263872,21263360,1024
6,Chr4,348781,349533,349157,752
6,Chr4,1005819,1006168,1005993,349
6,Chr4,12499109,12501355,12500232,2246
6,Chr5,4202762,4203121,4202942,359
6,Chr5,5502040,5503323,5502682,1283
6,Chr5,6719776,6724211,6721994,4435
6,Chr5,20831981,20833914,20832947,1933
6,Chr5,21723221,21729676,21726449,6455
6,Chr5,23790818,23792149,23791484,1331
6,Chr5,24952831,24954450,24953641,1619
6,Chr5,26849666,26849968,26849817,302
60,Chr1,3693660,3693829,3693744,169
60,Chr1,6653778,6656405,6655092,2627
60,Chr1,7446994,7449359,7448176,2365
60,Chr1,8405137,8431089,8418113,25952
60,Chr1,21238330,21240887,21239608,2557
60,Chr1,22783568,22784142,22783855,574
60,Chr1,25642382,25642492,25642437,110
60,Chr1,26748753,26756530,26752641,7777
60,Chr1,28425813,28431833,28428823,6020
60,Chr1,28476821,28477388,28477105,567
60,Chr1,30174582,30175311,30174946,729
60,Chr2,384718,385597,385158,879
60,Chr2,1007897,1008190,1008043,293
60,Chr2,7964486,7964854,7964670,368
60,Chr2,9390190,9390535,9390362,345
60,Chr2,13195264,13208563,13201914,13299
60,Chr3,425714,429879,427796,4165
60,Chr3,7626769,7628819,7627794,2050
60,Chr3,9837698,9837876,9837787,178
60,Chr3,11206344,11206646,11206495,302
60,Chr3,19083484,19084363,19083924,879
60,Chr4,6477354,6477361,6477358,7
60,Chr4,14795075,14795591,14795333,516
60,Chr4,18317215,18317361,18317288,146
60,Chr5,15461097,15461142,15461119,45
60,Chr5,20908476,20909426,20908951,950
60,Chr5,21663981,21665866,21664923,1885
60,Chr5,22718594,22724170,22721382,5576
61,Chr1,2982267,2985586,2983927,3319
61,Chr1,3296737,3296840,3296789,103
61,Chr1,9617065,9617820,9617443,755
61,Chr1,17352485,17352773,17352629,288
61,Chr1,23360148,23360258,23360203,110
61,Chr1,28516207,28516494,28516351,287
61,Chr1,28954843,28955311,28955077,468
61,Chr2,9002083,9002252,9002167,169
61,Chr2,11857425,11859173,11858299,1748
61,Chr2,12584024,12584978,12584501,954
61,Chr2,14471226,14471290,14471258,64
61,Chr2,16115678,16116318,16115998,640
61,Chr3,5642224,5642846,5642535,622
61,Chr3,6117193,6117764,6117479,571
61,Chr3,22374330,22374979,22374654,649
61,Chr4,955065,956151,955608,1086
61,Chr4,7274383,7274601,7274492,218
61,Chr4,8473554,8474301,8473928,747
61,Chr5,2096709,2096928,2096819,219
61,Chr5,2817713,2821040,2819377,3327
61,Chr5,3327129,3329363,3328246,2234
61,Chr5,4372126,4373886,4373006,1760
61,Chr5,4873353,4873794,4873573,441
61,Chr5,5899315,5899519,5899417,204
61,Chr5,15878487,15879014,15878751,527
61,Chr5,16929907,16929984,16929945,77
61,Chr5,18909491,18909500,18909495,9
62,Chr1,993176,993410,993293,234
62,Chr1,2101854,2104074,2102964,2220
62,Chr1,2852039,2857210,2854625,5171
62,Chr1,3822600,3823823,3823212,1223
62,Chr1,6869116,6869843,6869480,727
62,Chr1,7600207,7602632,7601419,2425
62,Chr1,8393239,8393447,8393343,208
62,Chr1,19221661,19225631,19223646,3970
62,Chr1,20235496,20236696,20236096,1200
62,Chr1,24122959,24124499,24123729,1540
62,Chr1,26661370,26662496,26661933,1126
62,Chr1,27164438,27165985,27165212,1547
62,Chr1,28868644,28868862,28868753,218
62,Chr2,7765934,7766588,7766261,654
62,Chr2,11565998,11566529,11566264,531
62,Chr2,14535810,14537685,14536748,1875
62,Chr2,16671985,16676029,16674007,4044
62,Chr2,18228405,18259080,18243743,30675
62,Chr2,19514285,19514710,19514497,425
62,Chr3,1950701,1951651,1951176,950
62,Chr3,5789712,5791783,5790748,2071
62,Chr3,6518138,6519252,6518695,1114
62,Chr3,7543669,7544205,7543937,536
62,Chr3,19292300,19293107,19292704,807
62,Chr3,19815433,19815842,19815637,409
62,Chr3,22189556,22189811,22189684,255
62,Chr3,22882080,22886784,22884432,4704
62,Chr3,23428713,23430067,23429390,1354
62,Chr4,5237147,5237293,5237220,146
62,Chr4,6426007,6426017,6426012,10
62,Chr4,9118054,9118995,9118524,941
62,Chr4,10714351,10714395,10714373,44
62,Chr4,11920934,11921228,11921081,294
62,Chr4,12376204,12377920,12377062,1716
62,Chr4,12384537,12384700,12384619,163
62,Chr4,13723230,13764990,13744110,41760
62,Chr4,13908827,13909113,13908970,286
62,Chr4,14357462,14359020,14358241,1558
62,Chr4,17194742,17195157,17194950,415
62,Chr5,3718461,3718706,3718583,245
62,Chr5,5411204,5411731,5411468,527
62,Chr5,23333212,23333356,23333284,144
62,Chr5,25423067,25424869,25423968,1802
62,Chr5,25991745,25992292,25992019,547
63,Chr1,1243133,1282224,1262679,39091
63,Chr1,2404671,2405552,2405111,881
63,Chr1,6015934,6017009,6016472,1075
63,Chr1,8172229,8172674,8172451,445
63,Chr1,10033951,10036211,10035081,2260
63,Chr1,19663215,19666250,19664733,3035
63,Chr1,27336265,27336476,27336371,211
63,Chr2,606247,607682,606965,1435
63,Chr2,11598794,11599507,11599150,713
63,Chr2,15828249,15829243,15828746,994
63,Chr3,80201,80465,80333,264
63,Chr3,1164903,1165113,1165008,210
63,Chr3,4995187,4996789,4995988,1602
63,Chr3,6265479,6265951,6265715,472
63,Chr3,8574909,8576243,8575576,1334
63,Chr3,18471530,18473622,18472576,2092
63,Chr3,20781391,20782256,20781823,865
63,Chr4,1304461,1304532,1304497,71
63,Chr4,7431899,7433442,7432671,1543
63,Chr4,9742569,9744268,9743419,1699
63,Chr4,11484166,11484448,11484307,282
63,Chr4,13504023,13504063,13504043,40
63,Chr4,13674650,13676386,13675518,1736
63,Chr5,7601982,7602618,7602300,636
63,Chr5,17206045,17206286,17206165,241
63,Chr5,20854248,20854972,20854610,724
63,Chr5,23065739,23065950,23065845,211
63,Chr5,23248305,23261694,23254999,13389
64,Chr1,146734,151617,149176,4883
64,Chr1,560551,562860,561705,2309
64,Chr1,1737485,1739832,1738659,2347
64,Chr1,26476948,26478170,26477559,1222
64,Chr2,16308041,16308429,16308235,388
64,Chr2,17166948,17168060,17167504,1112
64,Chr2,17253323,17320860,17287091,67537
64,Chr3,1065668,1066606,1066137,938
64,Chr3,6427060,6428780,6427920,1720
64,Chr3,9978958,9979230,9979094,272
64,Chr3,15183284,15183851,15183568,567
64,Chr3,18162749,18172911,18167830,10162
64,Chr3,20425033,20426904,20425969,1871
64,Chr3,20859441,20860136,20859789,695
64,Chr3,22323707,22323794,22323751,87
64,Chr3,22374979,22376196,22375587,1217
64,Chr4,1338596,1338905,1338750,309
64,Chr4,11987179,11995038,11991109,7859
64,Chr5,6928368,6928411,6928390,43
64,Chr5,7915857,7916186,7916021,329
64,Chr5,20753330,20754966,20754148,1636
64,Chr5,21296987,21297805,21297396,818
65,Chr1,1930841,1933762,1932301,2921
65,Chr1,2949556,2951283,2950420,1727
65,Chr1,5123732,5125595,5124664,1863
65,Chr1,10262446,10262456,10262451,10
65,Chr1,16787782,16788237,16788010,455
65,Chr1,19879914,19880424,19880169,510
65,Chr1,22274931,22275069,22275000,138
65,Chr1,30341174,30342936,30342055,1762
65,Chr2,2066807,2071438,2069123,4631
65,Chr2,11127154,11128073,11127614,919
65,Chr2,11886496,11888961,11887728,2465
65,Chr2,18228405,18259080,18243743,30675
65,Chr3,2665671,2667747,2666709,2076
65,Chr3,3098390,3101044,3099717,2654
65,Chr3,4581540,4583041,4582290,1501
65,Chr3,21352460,21352798,21352629,338
65,Chr3,21392487,21397021,21394754,4534
65,Chr3,22920458,22922075,22921266,1617
65,Chr4,5601535,5602025,5601780,490
65,Chr4,6441097,6442366,6441731,1269
65,Chr4,13097069,13097846,13097457,777
65,Chr4,14400690,14403301,14401996,2611
65,Chr5,497837,498005,497921,168
65,Chr5,2627886,2628233,2628060,347
65,Chr5,3631616,3632947,3632282,1331
65,Chr5,5203299,5204811,5204055,1512
65,Chr5,8072244,8080970,8076607,8726
65,Chr5,9546464,9546603,9546534,139
65,Chr5,15526653,15527184,15526919,531
65,Chr5,20509720,20513490,20511605,3770
65,Chr5,22164149,22164159,22164154,10
66,Chr1,559506,560551,560028,1045
66,Chr1,1889193,1889687,1889440,494
66,Chr1,4028320,4029763,4029042,1443
66,Chr1,5421597,5421942,5421769,345
66,Chr1,22273322,22274847,22274084,1525
66,Chr1,26595758,26602850,26599304,7092
66,Chr1,29841157,29841672,29841415,515
66,Chr2,205186,216827,211006,11641
66,Chr2,7944861,7946243,7945552,1382
66,Chr2,17892211,17916319,17904265,24108
66,Chr2,18445215,18446211,18445713,996
66,Chr2,19624003,19624413,19624208,410
66,Chr3,457233,457940,457587,707
66,Chr3,6320064,6320982,6320523,918
66,Chr3,8484619,8485617,8485118,998
66,Chr3,17391690,17392402,17392046,712
66,Chr3,18539396,18540140,18539768,744
66,Chr4,550033,551982,551007,1949
66,Chr4,5567344,5577313,5572328,9969
66,Chr4,11486442,11487275,11486858,833
66,Chr4,12495680,12496360,12496020,680
66,Chr5,1872781,1895107,1883944,22326
66,Chr5,5546722,5559677,5553200,12955
66,Chr5,8293371,8294496,8293933,1125
66,Chr5,19950234,19950324,19950279,90
66,Chr5,24909269,24912739,24911004,3470
66,Chr5,26504627,26505093,26504860,466
67,Chr1,1712117,1715676,1713897,3559
67,Chr1,2386464,2386860,2386662,396
67,Chr1,3273280,3274595,3273938,1315
67,Chr1,5324613,5324844,5324729,231
67,Chr1,27083453,27084473,27083963,1020
67,Chr2,1566972,1567190,1567081,218
67,Chr2,11354654,11354780,11354717,126
67,Chr2,12940503,12942221,12941362,1718
67,Chr2,14879745,14880499,14880122,754
67,Chr2,15119616,15121267,15120442,1651
67,Chr2,15592386,15593296,15592841,910
67,Chr2,17465753,17467285,17466519,1532
67,Chr2,18628286,18630933,18629610,2647
67,Chr3,906827,906854,906841,27
67,Chr3,1460881,1461869,1461375,988
67,Chr3,6948692,6970532,6959612,21840
67,Chr3,8112555,8114951,8113753,2396
67,Chr3,9152348,9152997,9152672,649
67,Chr3,11759171,11759520,11759345,349
67,Chr3,17537015,17537823,17537419,808
67,Chr3,19931624,19932950,19932287,1326
67,Chr3,20592402,20592677,20592540,275
67,Chr4,6246667,6247005,6246836,338
67,Chr4,13898493,13900199,13899346,1706
67,Chr5,1148192,1148378,1148285,186
67,Chr5,1536857,1538776,1537817,1919
67,Chr5,6766501,6767623,6767062,1122
67,Chr5,8919947,8921770,8920859,1823
67,Chr5,26184240,26184869,26184554,629
67,Chr5,26842976,26845718,26844347,2742
68,Chr1,136588,140411,138500,3823
68,Chr1,9637222,9637582,9637402,360
68,Chr1,9833359,9834339,9833849,980
68,Chr1,18028816,18029116,18028966,300
68,Chr1,18265647,18266028,18265837,381
68,Chr1,19768533,19768764,19768649,231
68,Chr1,25026396,25026426,25026411,30
68,Chr1,26404050,26404546,26404298,496
68,Chr1,28476821,28477388,28477105,567
68,Chr1,29321205,29321713,29321459,508
68,Chr2,5654790,5654988,5654889,198
68,Chr2,7994251,7994312,7994281,61
68,Chr2,9561424,9561733,9561578,309
68,Chr2,10346781,10347150,10346965,369
68,Chr2,11770706,11772268,11771487,1562
68,Chr2,13191584,13192011,13191798,427
68,Chr2,16299245,16300710,16299977,1465
68,Chr2,19467472,19467474,19467473,2
68,Chr2,19472211,19472652,19472431,441
68,Chr3,475370,477817,476594,2447
68,Chr3,9845083,9846009,9845546,926
68,Chr3,17691385,17692094,17691739,709
68,Chr3,18467460,18469493,18468476,2033
68,Chr3,20564147,20565761,20564954,1614
68,Chr3,21300447,21300953,21300700,506
68,Chr4,8258486,8260522,8259504,2036
68,Chr4,14240464,14240632,14240548,168
68,Chr5,5421619,5423065,5422342,1446
68,Chr5,7946836,7947412,7947124,576
68,Chr5,16454576,16456920,16455748,2344
68,Chr5,17694279,17695090,17694685,811
68,Chr5,23219077,23221364,23220221,2287
68,Chr5,25477444,25479199,25478322,1755
69,Chr1,872619,986719,929669,114100
69,Chr1,1854009,1854631,1854320,622
69,Chr1,2386860,2387932,2387396,1072
69,Chr1,5974996,5976924,5975960,1928
69,Chr1,7987801,7987932,7987867,131
69,Chr1,17253039,17253368,17253203,329
69,Chr1,21467369,21467375,21467372,6
69,Chr1,28928700,28929165,28928932,465
69,Chr2,2071438,2181177,2126308,109739
69,Chr2,11776419,11776958,11776689,539
69,Chr2,14827555,14840285,14833920,12730
69,Chr2,15719854,15720391,15720122,537
69,Chr2,15909048,15909465,15909256,417
69,Chr2,19008000,19009329,19008664,1329
69,Chr2,19544492,19544792,19544642,300
69,Chr3,220335,220659,220497,324
69,Chr3,607008,607255,607132,247
69,Chr3,2339666,2339825,2339746,159
69,Chr3,2612571,2613551,2613061,980
69,Chr3,3402152,3402837,3402494,685
69,Chr3,4162677,4166405,4164541,3728
69,Chr3,6090259,6091141,6090700,882
69,Chr3,6145746,6146454,6146100,708
69,Chr3,7384764,7385571,7385168,807
69,Chr3,8006589,8010293,8008441,3704
69,Chr3,15903761,15903802,15903781,41
69,Chr3,17244487,17245723,17245105,1236
69,Chr3,17734162,17740073,17737118,5911
69,Chr3,18465434,18466491,18465962,1057
69,Chr3,21015008,21016922,21015965,1914
69,Chr3,22162638,22163918,22163278,1280
69,Chr4,625415,626988,626201,1573
69,Chr4,6145761,6146015,6145888,254
69,Chr4,6817855,6819258,6818557,1403
69,Chr4,7437151,7437221,7437186,70
69,Chr4,9865445,9865729,9865587,284
69,Chr4,10807036,10807164,10807100,128
69,Chr4,11395063,11399326,11397195,4263
69,Chr4,12374490,12374691,12374590,201
69,Chr4,13180054,13182064,13181059,2010
69,Chr5,84356,89507,86932,5151
69,Chr5,260117,261157,260637,1040
69,Chr5,889893,890732,890313,839
69,Chr5,2485705,2485852,2485779,147
69,Chr5,3203757,3206360,3205059,2603
69,Chr5,3693139,3694573,3693856,1434
69,Chr5,4650512,4651560,4651036,1048
69,Chr5,5678789,5678993,5678891,204
69,Chr5,6847192,6849315,6848254,2123
69,Chr5,13909662,13913080,13911371,3418
69,Chr5,25753761,25754701,25754231,940
69,Chr5,26203591,26205488,26204539,1897
7,Chr1,183808,207856,195832,24048
7,Chr1,1124879,1131718,1128299,6839
7,Chr1,2298564,2301293,2299928,2729
7,Chr1,3523432,3526384,3524908,2952
7,Chr1,5125595,5127261,5126428,1666
7,Chr1,6017009,6017454,6017231,445
7,Chr1,8527998,8528228,8528113,230
7,Chr1,21711270,21711537,21711404,267
7,Chr1,22397345,22397633,22397489,288
7,Chr1,27206169,27206652,27206411,483
7,Chr1,28029562,28029717,28029640,155
7,Chr1,29387658,29387861,29387760,203
7,Chr2,8367977,8368093,8368035,116
7,Chr2,9396583,9397346,9396965,763
7,Chr2,13913348,13913690,13913519,342
7,Chr2,14346688,14347535,14347112,847
7,Chr2,16287118,16288759,16287938,1641
7,Chr2,17427394,17428103,17427748,709
7,Chr2,19505760,19506297,19506028,537
7,Chr3,910572,913873,912222,3301
7,Chr3,4008125,4009230,4008677,1105
7,Chr3,6737817,6738931,6738374,1114
7,Chr3,16708119,16708355,16708237,236
7,Chr3,20114895,20115975,20115435,1080
7,Chr4,6441097,6442366,6441731,1269
7,Chr4,12621706,12621996,12621851,290
7,Chr4,15971627,15972314,15971971,687
7,Chr4,17191805,17193550,17192677,1745
7,Chr5,2541282,2544379,2542830,3097
7,Chr5,7098209,7100967,7099588,2758
7,Chr5,19159862,19160029,19159946,167
7,Chr5,21739694,21739894,21739794,200
7,Chr5,22898014,22898239,22898126,225
7,Chr5,25266388,25266592,25266490,204
7,Chr5,26128609,26129542,26129075,933
70,Chr1,140411,140713,140562,302
70,Chr1,5021513,5035603,5028558,14090
70,Chr1,10214381,10214544,10214463,163
70,Chr1,11878702,11884144,11881423,5442
70,Chr1,18073296,18075913,18074604,2617
70,Chr1,19873401,19874388,19873895,987
70,Chr1,24372194,24373187,24372690,993
70,Chr2,255629,256737,256183,1108
70,Chr2,1010510,1025524,1018017,15014
70,Chr2,7817967,7818231,7818099,264
70,Chr2,18281172,18281974,18281573,802
70,Chr3,1291100,1291282,1291191,182
70,Chr3,5320752,5322200,5321476,1448
70,Chr3,17511921,17512325,17512123,404
70,Chr3,19944272,19945739,19945006,1467
70,Chr3,20067535,20068722,20068129,1187
70,Chr3,23167664,23167907,23167786,243
70,Chr4,1003632,1003742,1003687,110
70,Chr4,5925454,5926765,5926110,1311
70,Chr4,10231558,10231574,10231566,16
70,Chr4,18456290,18456525,18456408,235
70,Chr5,1742494,1750107,1746300,7613
70,Chr5,2986916,2987972,2987444,1056
70,Chr5,4642458,4642602,4642530,144
70,Chr5,6588497,6589021,6588759,524
70,Chr5,19775738,19784646,19780192,8908
70,Chr5,24137589,24140034,24138811,2445
70,Chr5,26956265,26956971,26956618,706
71,Chr1,673473,673556,673515,83
71,Chr1,858097,986719,922408,128622
71,Chr1,1747406,1748919,1748162,1513
71,Chr1,3658895,3662412,3660653,3517
71,Chr1,5509546,5510088,5509817,542
71,Chr1,6694039,6695021,6694530,982
71,Chr1,7350581,7352395,7351488,1814
71,Chr1,7382441,7383357,7382899,916
71,Chr1,8937260,8938844,8938052,1584
71,Chr1,21094839,21095418,21095129,579
71,Chr1,22375766,22376990,22376378,1224
71,Chr1,22379524,22382463,22380994,2939
71,Chr1,27414997,27421315,27418156,6318
71,Chr1,28651893,28724228,28688061,72335
71,Chr2,9052185,9052359,9052272,174
71,Chr2,14728458,14730392,14729425,1934
71,Chr2,17943226,17951178,17947202,7952
71,Chr3,3063624,3064808,3064216,1184
71,Chr3,5408660,5409235,5408948,575
71,Chr3,15402378,15402754,15402566,376
71,Chr3,17968551,17968753,17968652,202
71,Chr3,21738096,21739772,21738934,1676
71,Chr4,5786332,5789442,5787887,3110
71,Chr4,10526858,10527272,10527065,414
71,Chr4,17995857,17998829,17997343,2972
71,Chr5,2382953,2383959,2383456,1006
71,Chr5,3239625,3240751,3240188,1126
71,Chr5,4987260,4988197,4987728,937
71,Chr5,6429567,6430190,6429879,623
71,Chr5,7804514,7805972,7805243,1458
71,Chr5,7831503,7831891,7831697,388
71,Chr5,9265577,9268197,9266887,2620
71,Chr5,16776513,16777883,16777198,1370
71,Chr5,25399143,25400016,25399579,873
71,Chr5,26918485,26918921,26918703,436
72,Chr1,38554,90571,64562,52017
72,Chr1,4246803,4249323,4248063,2520
72,Chr1,4376682,4377533,4377108,851
72,Chr1,7267434,7267734,7267584,300
72,Chr1,10522293,10523059,10522676,766
72,Chr1,11221669,11222575,11222122,906
72,Chr1,20179638,20179967,20179802,329
72,Chr1,30383321,30383465,30383393,144
72,Chr2,5675174,5676455,5675814,1281
72,Chr2,9996478,9996685,9996582,207
72,Chr2,11810781,11812527,11811654,1746
72,Chr2,14526835,14527670,14527253,835
72,Chr2,16745006,16749710,16747358,4704
72,Chr3,4983505,4984888,4984197,1383
72,Chr3,5799286,5800089,5799688,803
72,Chr4,734884,734971,734928,87
72,Chr4,1204875,1205049,1204962,174
72,Chr4,13723230,13764990,13744110,41760
72,Chr5,1267480,1267809,1267644,329
72,Chr5,25066686,25066954,25066820,268
73,Chr1,3323366,3323661,3323514,295
73,Chr1,3800859,3801169,3801014,310
73,Chr1,4273900,4275011,4274456,1111
73,Chr1,4874819,4875390,4875105,571
73,Chr1,8392566,8392782,8392674,216
73,Chr1,12917740,12918082,12917911,342
73,Chr1,19043546,19043833,19043690,287
73,Chr1,22737298,22738383,22737840,1085
73,Chr1,24141730,24144345,24143038,2615
73,Chr1,24825297,24825979,24825638,682
73,Chr1,28281976,28284740,28283358,2764
73,Chr2,682346,683583,682964,1237
73,Chr2,9968495,9968835,9968665,340
73,Chr2,15189853,15190819,15190336,966
73,Chr2,16252014,16252386,16252200,372
73,Chr3,334185,334454,334319,269
73,Chr3,2348351,2349512,2348931,1161
73,Chr3,4425464,4425607,4425536,143
73,Chr3,5255728,5255916,5255822,188
73,Chr3,6774415,6775372,6774893,957
73,Chr3,7321883,7322239,7322061,356
73,Chr3,19651506,19651605,19651556,99
73,Chr3,21130704,21130742,21130723,38
73,Chr3,22378092,22378200,22378146,108
73,Chr4,302670,303969,303320,1299
73,Chr4,8981423,8981578,8981501,155
73,Chr4,12766809,12767770,12767289,961
73,Chr5,1118019,1118453,1118236,434
73,Chr5,1740854,1741385,1741120,531
73,Chr5,2633698,2636028,2634863,2330
73,Chr5,5276080,5276527,5276304,447
73,Chr5,7953109,7953200,7953155,91
73,Chr5,18069633,18070979,18070306,1346
73,Chr5,18929808,18930572,18930190,764
73,Chr5,21663981,21665866,21664923,1885
73,Chr5,22574802,22574880,22574841,78
73,Chr5,25720100,25721985,25721042,1885
74,Chr1,109627,109804,109715,177
74,Chr1,3320999,3321163,3321081,164
74,Chr1,4484243,4484864,4484553,621
74,Chr1,5162272,5162377,5162324,105
74,Chr1,18424688,18424921,18424804,233
74,Chr1,25298231,25298369,25298300,138
74,Chr1,27394130,27394560,27394345,430
74,Chr2,11673741,11674125,11673933,384
74,Chr2,15276628,15278555,15277592,1927
74,Chr2,17881666,17887845,17884756,6179
74,Chr3,2255530,2257141,2256336,1611
74,Chr3,5094367,5124565,5109466,30198
74,Chr3,10249905,10256208,10253057,6303
74,Chr3,18145329,18148349,18146839,3020
74,Chr3,19839927,19840611,19840269,684
74,Chr3,20945082,20945927,20945504,845
74,Chr4,6474565,6474839,6474702,274
74,Chr4,10898180,10898345,10898262,165
74,Chr4,12858746,12860195,12859470,1449
74,Chr5,5032970,5033128,5033049,158
74,Chr5,15901347,15901998,15901673,651
74,Chr5,23690355,23690633,23690494,278
74,Chr5,24758290,24761143,24759716,2853
74,Chr5,26456443,26458198,26457321,1755
75,Chr1,5322340,5324613,5323476,2273
75,Chr1,6966232,6967202,6966717,970
75,Chr1,10846301,10846603,10846452,302
75,Chr1,16125847,16127228,16126537,1381
75,Chr1,18360131,18361539,18360835,1408
75,Chr1,18441416,18441699,18441558,283
75,Chr1,19282082,19282570,19282326,488
75,Chr1,20193033,20193517,20193275,484
75,Chr1,23087532,23088031,23087782,499
75,Chr1,26122022,26123782,26122902,1760
75,Chr1,26559548,26561367,26560458,1819
75,Chr1,26659218,26660269,26659744,1051
75,Chr1,27151832,27152897,27152364,1065
75,Chr1,28724228,28739401,28731814,15173
75,Chr1,30156853,30157945,30157399,1092
75,Chr1,30241606,30242349,30241978,743
75,Chr2,332000,332300,332150,300
75,Chr2,815496,816200,815848,704
75,Chr2,2243035,2243797,2243416,762
75,Chr2,5923589,5931163,5927376,7574
75,Chr2,9214493,9214877,9214685,384
75,Chr2,10568722,10568886,10568804,164
75,Chr2,11648375,11648776,11648575,401
75,Chr2,12217028,12219101,12218064,2073
75,Chr2,16676029,16679962,16677995,3933
75,Chr2,17950237,17951178,17950707,941
75,Chr3,3680933,3684719,3682826,3786
75,Chr3,5165948,5182864,5174406,16916
75,Chr3,5826061,5826959,5826510,898
75,Chr3,17543268,17544532,17543900,1264
75,Chr3,21242698,21243607,21243152,909
75,Chr3,22230007,22231021,22230514,1014
75,Chr4,6731577,6732472,6732025,895
75,Chr4,11979444,11987179,11983312,7735
75,Chr5,3062693,3063671,3063182,978
75,Chr5,7298529,7298920,7298725,391
75,Chr5,24461395,24461601,24461498,206
76,Chr1,1541172,1543645,1542408,2473
76,Chr1,3547643,3547767,3547705,124
76,Chr1,5409251,5410031,5409641,780
76,Chr1,7269907,7270021,7269964,114
76,Chr1,20267629,20272327,20269978,4698
76,Chr1,20669555,20669794,20669675,239
76,Chr1,24288181,24288334,24288257,153
76,Chr1,26092584,26094338,26093461,1754
76,Chr1,27404519,27410156,27407337,5637
76,Chr1,29970074,29979973,29975024,9899
76,Chr2,2205988,2206009,2205998,21
76,Chr2,7951717,7954092,7952905,2375
76,Chr2,10079635,10079829,10079732,194
76,Chr2,11109439,11109572,11109505,133
76,Chr2,11618716,11619363,11619040,647
76,Chr2,19261210,19261847,19261528,637
76,Chr3,1351276,1351507,1351392,231
76,Chr3,10686909,10689332,10688121,2423
76,Chr4,7198395,7199000,7198697,605
76,Chr4,11995038,11995362,11995200,324
76,Chr5,271872,277216,274544,5344
76,Chr5,2704015,2715275,2709645,11260
76,Chr5,3845909,3846014,3845961,105
76,Chr5,7979855,7980019,7979937,164
76,Chr5,8989270,8989611,8989440,341
76,Chr5,21241003,21241461,21241232,458
76,Chr5,21970508,21971317,21970912,809
76,Chr5,26236880,26237555,26237218,675
77,Chr1,1779272,1781121,1780196,1849
77,Chr1,2435777,2436334,2436055,557
77,Chr1,3442204,3443081,3442642,877
77,Chr1,9092461,9094151,9093306,1690
77,Chr1,10888988,10890900,10889944,1912
77,Chr1,19500392,19500744,19500568,352
77,Chr1,20839298,20839476,20839387,178
77,Chr1,22265449,22266153,22265801,704
77,Chr1,28151571,28152727,28152149,1156
77,Chr1,29308850,29309397,29309124,547
77,Chr1,29816010,29817638,29816824,1628
77,Chr2,8103247,8104251,8103749,1004
77,Chr2,11013424,11013468,11013446,44
77,Chr2,14440547,14440797,14440672,250
77,Chr2,15959588,15960597,15960092,1009
77,Chr2,16334152,16335487,16334820,1335
77,Chr2,18369411,18369513,18369462,102
77,Chr3,2217317,2218055,2217686,738
77,Chr3,2912070,2912311,2912190,241
77,Chr3,10874466,10874583,10874524,117
77,Chr3,16491831,16493876,16492853,2045
77,Chr3,18763059,18765023,18764041,1964
77,Chr3,22973489,22977873,22975681,4384
77,Chr3,23421393,23421925,23421659,532
77,Chr4,5366209,5367784,5366997,1575
77,Chr4,11480932,11482674,11481803,1742
77,Chr4,11773485,11774265,11773875,780
77,Chr4,12479400,12484019,12481710,4619
77,Chr4,15460487,15466933,15463710,6446
77,Chr5,19851904,19852208,19852056,304
77,Chr5,26096621,26097306,26096963,685
77,Chr5,26605673,26606292,26605983,619
78,Chr1,473429,478208,475819,4779
78,Chr1,1064221,1065037,1064629,816
78,Chr1,4219587,4220180,4219883,593
78,Chr1,6678403,6679053,6678728,650
78,Chr1,25409585,25410025,25409805,440
78,Chr2,10301764,10304481,10303122,2717
78,Chr2,11294691,11295005,11294848,314
78,Chr2,12288355,12289382,12288869,1027
78,Chr2,14541408,14542046,14541727,638
78,Chr3,919068,920200,919634,1132
78,Chr3,2381819,2382466,2382143,647
78,Chr3,10678739,10679950,10679345,1211
78,Chr3,22393270,22393470,22393370,200
78,Chr4,13202444,13204049,13203246,1605
78,Chr4,14043844,14044027,14043936,183
78,Chr5,3144654,3145133,3144894,479
78,Chr5,6140401,6140761,6140581,360
78,Chr5,21763740,21765750,21764745,2010
78,Chr5,22703313,22703671,22703492,358
78,Chr5,24674596,24675313,24674954,717
79,Chr1,154679,158680,156679,4001
79,Chr1,4654291,4658479,4656385,4188
79,Chr1,7516916,7519458,7518187,2542
79,Chr1,9747887,9748630,9748259,743
79,Chr1,11470992,11471209,11471100,217
79,Chr1,19927229,19927795,19927512,566
79,Chr1,20600281,20600365,20600323,84
79,Chr1,27691937,27693027,27692482,1090
79,Chr2,9356663,9357937,9357300,1274
79,Chr2,13018058,13018475,13018266,417
79,Chr2,14790123,14793183,14791653,3060
79,Chr3,2463845,2464533,2464189,688
79,Chr3,4673496,4673621,4673558,125
79,Chr3,20338983,20342332,20340657,3349
79,Chr4,7333312,7333513,7333412,201
79,Chr5,8562140,8562502,8562321,362
79,Chr5,16840930,16841688,16841309,758
8,Chr1,1436602,1437298,1436950,696
8,Chr1,2324135,2325347,2324741,1212
8,Chr1,5852334,5853037,5852686,703
8,Chr1,22454899,22455506,22455203,607
8,Chr2,7667306,7667617,7667462,311
8,Chr2,15779894,15781360,15780627,1466
8,Chr2,18684529,18685959,18685244,1430
8,Chr3,188032,190896,189464,2864
8,Chr3,1525377,1525746,1525561,369
8,Chr3,4849185,4849481,4849333,296
8,Chr3,18958497,18958602,18958549,105
8,Chr3,21240517,21241444,21240981,927
8,Chr4,202156,202361,202258,205
8,Chr4,959529,960459,959994,930
8,Chr4,7811317,7812279,7811798,962
8,Chr4,14052783,14053834,14053309,1051
8,Chr4,18569661,18570639,18570150,978
80,Chr1,266850,266943,266896,93
80,Chr1,3191418,3191620,3191519,202
80,Chr1,4526278,4527060,4526669,782
80,Chr1,6228088,6228911,6228500,823
80,Chr1,9728401,9728803,9728602,402
80,Chr1,17823977,17824290,17824133,313
80,Chr1,24867641,24867891,24867766,250
80,Chr1,26514127,26514850,26514489,723
80,Chr1,27733722,27734879,27734300,1157
80,Chr2,18104446,18105570,18105008,1124
80,Chr3,2492305,2494690,2493497,2385
80,Chr3,6746024,6747517,6746770,1493
80,Chr3,7237023,7238252,7237637,1229
80,Chr3,9198027,9198525,9198276,498
80,Chr3,9831669,9832264,9831967,595
80,Chr4,13219827,13220065,13219946,238
80,Chr4,14137789,14138016,14137903,227
80,Chr4,18241054,18244780,18242917,3726
80,Chr5,452536,454521,453528,1985
80,Chr5,1514028,1518399,1516214,4371
80,Chr5,4221954,4222196,4222075,242
80,Chr5,8360478,8361320,8360899,842
80,Chr5,18582589,18582830,18582709,241
80,Chr5,21001533,21002556,21002045,1023
80,Chr5,26626889,26627233,26627061,344
81,Chr1,7865120,7865979,7865550,859
81,Chr1,20255999,20259919,20257959,3920
81,Chr1,21028327,21028519,21028423,192
81,Chr1,22378748,22379086,22378917,338
81,Chr1,23643997,23644399,23644198,402
81,Chr1,27092906,27093802,27093354,896
81,Chr1,27601990,27604691,27603340,2701
81,Chr2,7954092,7954917,7954504,825
81,Chr2,14793183,14798673,14795928,5490
81,Chr3,3962577,3963444,3963011,867
81,Chr3,6835514,6837672,6836593,2158
81,Chr3,7982677,7983421,7983049,744
81,Chr3,23344411,23344521,23344466,110
81,Chr4,10355440,10355456,10355448,16
81,Chr4,18507588,18507910,18507749,322
81,Chr5,575349,575916,575633,567
81,Chr5,13763627,13768326,13765977,4699
81,Chr5,19567638,19569914,19568776,2276
82,Chr1,20181076,20181556,20181316,480
82,Chr1,23006712,23010779,23008746,4067
82,Chr1,24866402,24867149,24866776,747
82,Chr1,27452388,27454324,27453356,1936
82,Chr1,27869924,27870314,27870119,390
82,Chr1,29183540,29184175,29183858,635
82,Chr2,963589,963714,963651,125
82,Chr2,9396583,9397346,9396965,763
82,Chr2,14245893,14253264,14249579,7371
82,Chr2,19584125,19585357,19584741,1232
82,Chr3,425451,425629,425540,178
82,Chr3,2541039,2542530,2541785,1491
82,Chr3,4115834,4117279,4116556,1445
82,Chr3,4752772,4752811,4752792,39
82,Chr3,7867266,7868437,7867852,1171
82,Chr3,10249905,10256208,10253057,6303
82,Chr3,16803562,16803678,16803620,116
82,Chr4,1102670,1104046,1103358,1376
82,Chr4,7144459,7145341,7144900,882
82,Chr4,8103287,8104205,8103746,918
82,Chr4,10388390,10388806,10388598,416
82,Chr4,11548102,11548533,11548318,431
82,Chr5,463361,464507,463934,1146
82,Chr5,2910749,2930912,2920831,20163
82,Chr5,7006594,7006836,7006715,242
82,Chr5,14223748,14225486,14224617,1738
82,Chr5,14878310,14878366,14878338,56
82,Chr5,17139077,17141281,17140179,2204
82,Chr5,23644502,23645434,23644968,932
83,Chr1,562860,563367,563114,507
83,Chr1,1969492,1970920,1970206,1428
83,Chr1,7172153,7172158,7172155,5
83,Chr1,8403410,8404157,8403784,747
83,Chr1,22001957,22002168,22002063,211
83,Chr1,24007089,24007939,24007514,850
83,Chr1,28047569,28052680,28050125,5111
83,Chr2,14226397,14230384,14228391,3987
83,Chr2,15898529,15899228,15898879,699
83,Chr2,18815914,18817891,18816902,1977
83,Chr2,19355295,19356332,19355813,1037
83,Chr3,167236,168285,167760,1049
83,Chr3,3982141,3986808,3984475,4667
83,Chr3,11836255,11836757,11836506,502
83,Chr3,18787031,18787083,18787057,52
83,Chr4,6731577,6732472,6732025,895
83,Chr4,13362035,13362084,13362059,49
83,Chr4,14330899,14331690,14331295,791
83,Chr5,330713,330932,330823,219
83,Chr5,1390237,1392983,1391610,2746
83,Chr5,2397417,2398108,2397763,691
83,Chr5,3933074,3933250,3933162,176
84,Chr1,183808,207856,195832,24048
84,Chr1,1146913,1147537,1147225,624
84,Chr1,2527937,2528034,2527985,97
84,Chr1,3351027,3354275,3352651,3248
84,Chr1,6281945,6283826,6282885,1881
84,Chr1,7302163,7302894,7302529,731
84,Chr1,10211457,10212255,10211856,798
84,Chr1,13050968,13051029,13050998,61
84,Chr1,20786161,20786209,20786185,48
84,Chr1,23501264,23509118,23505191,7854
84,Chr1,25025940,25026255,25026098,315
84,Chr1,25307206,25307323,25307264,117
84,Chr2,438758,439457,439108,699
84,Chr2,1130209,1130417,1130313,208
84,Chr2,8094679,8096122,8095401,1443
84,Chr2,8503032,8503212,8503122,180
84,Chr2,13997153,14000726,13998939,3573
84,Chr2,14428356,14429294,14428825,938
84,Chr2,18070625,18071720,18071173,1095
84,Chr3,10737582,10738388,10737985,806
84,Chr3,17999004,17999376,17999190,372
84,Chr3,18487461,18488444,18487953,983
84,Chr3,19668458,19668875,19668666,417
84,Chr3,20298178,20300032,20299105,1854
84,Chr3,20870678,20871915,20871296,1237
84,Chr3,22195776,22196120,22195948,344
84,Chr4,719640,719673,719656,33
84,Chr4,11271923,11272153,11272038,230
84,Chr4,12450369,12450579,12450474,210
84,Chr4,13723230,13764990,13744110,41760
84,Chr4,16456416,16457624,16457020,1208
84,Chr5,2351901,2352665,2352283,764
84,Chr5,3052313,3054764,3053539,2451
84,Chr5,4283154,4284472,4283813,1318
84,Chr5,6611120,6611335,6611228,215
84,Chr5,7802945,7804126,7803535,1181
84,Chr5,22608688,22611342,22610015,2654
85,Chr1,1744306,1745832,1745069,1526
85,Chr1,5828152,5829830,5828991,1678
85,Chr1,12025089,12037278,12031183,12189
85,Chr2,378561,378796,378679,235
85,Chr2,8697128,8697336,8697232,208
85,Chr2,9404508,9405329,9404918,821
85,Chr2,11564017,11564215,11564116,198
85,Chr2,13656781,13657047,13656914,266
85,Chr2,15494854,15495085,15494970,231
85,Chr2,18707774,18707995,18707884,221
85,Chr3,583317,583552,583435,235
85,Chr3,906827,908004,907415,1177
85,Chr3,2057143,2059982,2058563,2839
85,Chr3,2562327,2562444,2562385,117
85,Chr3,4235384,4235854,4235619,470
85,Chr3,6166253,6167047,6166650,794
85,Chr3,18363255,18365448,18364351,2193
85,Chr3,21626834,21629053,21627944,2219
85,Chr4,411023,412126,411575,1103
85,Chr4,6927440,6929713,6928576,2273
85,Chr4,10015421,10016399,10015910,978
85,Chr4,13068980,13069172,13069076,192
85,Chr4,13129368,13130272,13129820,904
85,Chr5,869091,873180,871135,4089
85,Chr5,4275924,4276138,4276031,214
85,Chr5,5235906,5237963,5236934,2057
85,Chr5,17639495,17640503,17639999,1008
85,Chr5,18803923,18806393,18805158,2470
85,Chr5,19702882,19703106,19702994,224
86,Chr1,4398370,4398585,4398478,215
86,Chr1,6975620,6976899,6976260,1279
86,Chr1,7380087,7382314,7381201,2227
86,Chr1,27734879,27734933,27734906,54
86,Chr2,700790,701817,701304,1027
86,Chr2,14737190,14741695,14739442,4505
86,Chr2,17355101,17357560,17356331,2459
86,Chr3,2441096,2441405,2441250,309
86,Chr4,70465,70933,70699,468
86,Chr4,1175852,1177243,1176548,1391
86,Chr4,14124934,14126662,14125798,1728
86,Chr5,4376276,4378873,4377574,2597
86,Chr5,5714252,5715612,5714932,1360
86,Chr5,6935748,6936720,6936234,972
86,Chr5,22178793,22179273,22179033,480
87,Chr1,560551,562860,561705,2309
87,Chr1,2753410,2754080,2753745,670
87,Chr1,2931959,2932672,2932315,713
87,Chr1,4212883,4213951,4213417,1068
87,Chr1,5428926,5429515,5429220,589
87,Chr1,9240814,9243831,9242322,3017
87,Chr1,27957704,27959268,27958486,1564
87,Chr1,30385511,30386366,30385939,855
87,Chr2,7514290,7514447,7514368,157
87,Chr2,11823002,11824281,11823642,1279
87,Chr2,13115714,13127258,13121486,11544
87,Chr2,14120070,14120633,14120352,563
87,Chr2,15695418,15697230,15696324,1812
87,Chr2,17925170,17927744,17926457,2574
87,Chr2,18472216,18473450,18472833,1234
87,Chr2,19045961,19046878,19046419,917
87,Chr3,1018322,1018624,1018473,302
87,Chr3,4811682,4812413,4812048,731
87,Chr3,8487535,8490902,8489219,3367
87,Chr3,8909565,8910864,8910215,1299
87,Chr3,18809125,18810296,18809711,1171
87,Chr3,19312262,19312285,19312274,23
87,Chr3,22279142,22279184,22279163,42
87,Chr4,11027201,11027581,11027391,380
87,Chr4,18380586,18385893,18383240,5307
87,Chr5,220718,227039,223878,6321
87,Chr5,3904231,3906618,3905425,2387
87,Chr5,5009282,5009536,5009409,254
87,Chr5,6611600,6612141,6611870,541
87,Chr5,21140919,21141108,21141013,189
87,Chr5,21892310,21892677,21892494,367
87,Chr5,23005292,23005461,23005376,169
87,Chr5,24531262,24531601,24531432,339
87,Chr5,25880741,25881387,25881064,646
88,Chr1,1573327,1574398,1573863,1071
88,Chr1,4897356,4899961,4898658,2605
88,Chr1,5834726,5836762,5835744,2036
88,Chr1,6522606,6525536,6524071,2930
88,Chr1,8097525,8098289,8097907,764
88,Chr1,20340342,20342252,20341297,1910
88,Chr1,27200273,27201412,27200843,1139
88,Chr1,27698788,27699611,27699200,823
88,Chr1,28954629,28954843,28954736,214
88,Chr2,7819098,7819122,7819110,24
88,Chr2,10501570,10501769,10501670,199
88,Chr2,18169172,18170309,18169740,1137
88,Chr2,18264856,18265170,18265013,314
88,Chr2,19226098,19227607,19226852,1509
88,Chr3,3423978,3424000,3423989,22
88,Chr3,6576312,6593502,6584907,17190
88,Chr3,23293165,23293363,23293264,198
88,Chr4,525204,525215,525210,11
88,Chr4,7483344,7483895,7483620,551
88,Chr4,9136030,9136942,9136486,912
88,Chr4,11868849,11869148,11868999,299
88,Chr5,244977,245966,245471,989
88,Chr5,2033992,2034809,2034400,817
88,Chr5,4876617,4877059,4876838,442
88,Chr5,23594589,23594955,23594772,366
88,Chr5,26649113,26649764,26649439,651
89,Chr1,1163523,1163842,1163683,319
89,Chr1,5194787,5195362,5195075,575
89,Chr1,7086312,7086348,7086330,36
89,Chr1,7096529,7097365,7096947,836
89,Chr1,10546534,10546709,10546622,175
89,Chr1,12436199,12436858,12436529,659
89,Chr1,18323103,18327124,18325113,4021
89,Chr1,24136690,24137106,24136898,416
89,Chr1,27639053,27639061,27639057,8
89,Chr1,28086924,28087518,28087221,594
89,Chr1,29734905,29735016,29734961,111
89,Chr1,30331756,30333965,30332860,2209
89,Chr2,12150476,12150579,12150528,103
89,Chr2,13260673,13263852,13262263,3179
89,Chr2,16259804,16260812,16260308,1008
89,Chr2,17168060,17170480,17169270,2420
89,Chr2,18033518,18035324,18034421,1806
89,Chr3,35190,37066,36128,1876
89,Chr3,892830,893010,892920,180
89,Chr3,3163805,3164703,3164254,898
89,Chr3,6521894,6529843,6525868,7949
89,Chr3,7477552,7479234,7478393,1682
89,Chr3,7545241,7546118,7545679,877
89,Chr3,18053145,18057260,18055203,4115
89,Chr3,21656386,21677904,21667145,21518
89,Chr4,10958171,10958394,10958283,223
89,Chr4,12867896,12868261,12868078,365
89,Chr4,15069872,15070653,15070262,781
89,Chr5,672506,675453,673980,2947
89,Chr5,6246612,6247821,6247216,1209
89,Chr5,15632129,15632615,15632372,486
9,Chr1,3080418,3080959,3080688,541
9,Chr1,4320145,4322716,4321431,2571
9,Chr1,5575170,5576827,5575998,1657
9,Chr1,8484730,8486579,8485654,1849
9,Chr1,9463710,9472228,9467969,8518
9,Chr1,10031312,10032561,10031936,1249
9,Chr1,13142745,13143966,13143355,1221
9,Chr1,23498972,23499363,23499168,391
9,Chr1,27838557,27838742,27838649,185
9,Chr2,505020,505255,505138,235
9,Chr2,14428356,14429294,14428825,938
9,Chr2,16648496,16650174,16649335,1678
9,Chr3,412440,412667,412554,227
9,Chr3,7049755,7051506,7050631,1751
9,Chr3,17845957,17846051,17846004,94
9,Chr3,22022365,22027503,22024934,5138
9,Chr4,799789,800035,799912,246
9,Chr4,7463073,7463965,7463519,892
9,Chr4,8105206,8106089,8105648,883
9,Chr4,8603163,8604836,8603999,1673
9,Chr4,14330660,14330899,14330780,239
9,Chr4,15204543,15206109,15205326,1566
9,Chr4,17966425,17966583,17966504,158
9,Chr5,230709,230766,230737,57
9,Chr5,754787,756827,755807,2040
9,Chr5,3132649,3132657,3132653,8
9,Chr5,3851004,3851701,3851352,697
9,Chr5,9002644,9003896,9003270,1252
9,Chr5,14706540,14707094,14706817,554
9,Chr5,16180187,16180710,16180449,523
9,Chr5,21441322,21441595,21441458,273
9,Chr5,23221378,23223138,23222258,1760
9,Chr5,24782084,24782534,24782309,450
9,Chr5,25435339,25435860,25435599,521
9,Chr5,25884574,25884709,25884642,135
90,Chr1,780156,783499,781828,3343
90,Chr1,4193422,4193460,4193441,38
90,Chr1,5054681,5070376,5062529,15695
90,Chr1,7098732,7099357,7099044,625
90,Chr1,8977128,8985127,8981128,7999
90,Chr1,9750386,9753494,9751940,3108
90,Chr1,19604495,19608853,19606674,4358
90,Chr1,26556059,26559548,26557803,3489
90,Chr1,30280707,30280986,30280847,279
90,Chr2,4808150,4808219,4808184,69
90,Chr2,5391380,5391805,5391592,425
90,Chr2,8937806,8938158,8937982,352
90,Chr2,15052012,15052502,15052257,490
90,Chr2,19020676,19044487,19032582,23811
90,Chr2,19096571,19096844,19096707,273
90,Chr3,2093179,2093246,2093213,67
90,Chr3,6778178,6779954,6779066,1776
90,Chr3,7366109,7367733,7366921,1624
90,Chr3,9140178,9140437,9140308,259
90,Chr3,20377333,20378231,20377782,898
90,Chr3,21551459,21557825,21554642,6366
90,Chr3,22293364,22294395,22293880,1031
90,Chr3,22953341,22955353,22954347,2012
90,Chr4,4807883,4808549,4808216,666
90,Chr4,8833843,8834827,8834335,984
90,Chr4,9374414,9375982,9375198,1568
90,Chr4,12496360,12496602,12496481,242
90,Chr5,16931336,16932142,16931739,806
90,Chr5,17498765,17498831,17498798,66
91,Chr1,2619464,2622605,2621034,3141
91,Chr1,3084103,3088287,3086195,4184
91,Chr1,13033405,13035737,13034571,2332
91,Chr1,18415808,18420121,18417964,4313
91,Chr2,19649509,19650566,19650037,1057
91,Chr3,3483442,3486437,3484940,2995
91,Chr3,5400665,5401412,5401039,747
91,Chr4,1174782,1175430,1175106,648
91,Chr4,8966280,8967403,8966842,1123
91,Chr4,10970039,10970731,10970385,692
91,Chr5,436449,436960,436705,511
91,Chr5,3460649,3461513,3461081,864
91,Chr5,16636358,16637496,16636927,1138
91,Chr5,17100654,17100817,17100736,163
91,Chr5,24448519,24448948,24448733,429
92,Chr1,4530451,4531439,4530945,988
92,Chr1,7618530,7625108,7621819,6578
92,Chr1,8723543,8723648,8723595,105
92,Chr1,17361071,17366029,17363550,4958
92,Chr1,25230873,25231818,25231345,945
92,Chr1,26485808,26488015,26486912,2207
92,Chr1,28454138,28454226,28454182,88
92,Chr2,2023202,2023986,2023594,784
92,Chr2,10582822,10583346,10583084,524
92,Chr2,16051859,16052443,16052151,584
92,Chr3,264687,265272,264979,585
92,Chr3,848709,848845,848777,136
92,Chr3,5483910,5485603,5484756,1693
92,Chr3,6560320,6567142,6563731,6822
92,Chr3,7258911,7259020,7258965,109
92,Chr3,8895149,8895463,8895306,314
92,Chr3,10444374,10450895,10447634,6521
92,Chr3,18442286,18444954,18443620,2668
92,Chr3,20674237,20674526,20674381,289
92,Chr3,21282963,21283472,21283217,509
92,Chr3,22794359,22794519,22794439,160
92,Chr3,23291586,23292275,23291930,689
92,Chr4,6202112,6203259,6202686,1147
92,Chr4,18549406,18549516,18549461,110
92,Chr5,4225226,4225576,4225401,350
92,Chr5,25901005,25901323,25901164,318
92,Chr5,26386030,26388406,26387218,2376
93,Chr1,5127313,5127398,5127355,85
93,Chr1,10148186,10148222,10148204,36
93,Chr1,12625829,12626439,12626134,610
93,Chr1,22273322,22274847,22274084,1525
93,Chr1,25362344,25362841,25362592,497
93,Chr2,2066807,2071438,2069123,4631
93,Chr2,10268896,10269054,10268975,158
93,Chr2,18589678,18591645,18590662,1967
93,Chr3,2614406,2617289,2615848,2883
93,Chr3,4254759,4259107,4256933,4348
93,Chr3,5252876,5253129,5253002,253
93,Chr3,17548642,17549329,17548986,687
93,Chr3,19913837,19914283,19914060,446
93,Chr4,528200,528685,528442,485
93,Chr4,17886301,17887652,17886977,1351
93,Chr5,1824992,1832199,1828596,7207
93,Chr5,2325754,2326202,2325978,448
93,Chr5,3734699,3735068,3734883,369
93,Chr5,21018225,21018234,21018229,9
93,Chr5,24237655,24238541,24238098,886
93,Chr5,24909269,24912739,24911004,3470
94,Chr1,2277013,2277469,2277241,456
94,Chr1,5143920,5143942,5143931,22
94,Chr1,25226855,25230255,25228555,3400
94,Chr1,27829653,27829931,27829792,278
94,Chr1,28294829,28295833,28295331,1004
94,Chr2,7575947,7577200,7576573,1253
94,Chr2,14535810,14537685,14536748,1875
94,Chr2,15056693,15057449,15057071,756
94,Chr2,16492361,16495483,16493922,3122
94,Chr2,17444327,17445044,17444685,717
94,Chr2,19405540,19406812,19406176,1272
94,Chr3,3365455,3371744,3368599,6289
94,Chr3,5079992,5124565,5102278,44573
94,Chr3,6142921,6144169,6143545,1248
94,Chr3,7940701,7941873,7941287,1172
94,Chr3,11746371,11748041,11747206,1670
94,Chr3,19637216,19642149,19639682,4933
94,Chr3,21252140,21252409,21252274,269
94,Chr5,1444591,1447030,1445811,2439
94,Chr5,3846459,3851004,3848731,4545
94,Chr5,5391590,5392510,5392050,920
94,Chr5,16939447,16940680,16940063,1233
94,Chr5,20970695,20970932,20970813,237
94,Chr5,25533444,25535359,25534402,1915
95,Chr1,210850,266254,238552,55404
95,Chr1,858097,986719,922408,128622
95,Chr1,1855506,1861567,1858536,6061
95,Chr1,3323366,3354275,3338820,30909
95,Chr1,9330869,9331592,9331231,723
95,Chr1,11112720,11113809,11113264,1089
95,Chr1,11914409,11921283,11917846,6874
95,Chr1,18288412,18288699,18288556,287
95,Chr1,21112236,21113016,21112626,780
95,Chr1,21421201,21422122,21421661,921
95,Chr1,25301865,25302310,25302087,445
95,Chr1,30241511,30242349,30241930,838
95,Chr2,10851305,10851854,10851579,549
95,Chr2,14180967,14181204,14181085,237
95,Chr2,16488841,16489448,16489145,607
95,Chr2,16580516,16582019,16581268,1503
95,Chr3,3406567,3407803,3407185,1236
95,Chr3,8590092,8591175,8590634,1083
95,Chr3,12456155,12456287,12456221,132
95,Chr3,15865377,15865589,15865483,212
95,Chr3,21009716,21010062,21009889,346
95,Chr3,21738096,21739772,21738934,1676
95,Chr3,22297619,22298599,22298109,980
95,Chr3,22392098,22392706,22392402,608
95,Chr4,190004,190806,190405,802
95,Chr4,13461130,13461460,13461295,330
95,Chr4,18567311,18569661,18568486,2350
95,Chr5,835606,836484,836045,878
95,Chr5,3237771,3239054,3238413,1283
95,Chr5,16762689,16763156,16762923,467
95,Chr5,17105053,17106368,17105711,1315
95,Chr5,17880098,17880308,17880203,210
95,Chr5,20919034,20919158,20919096,124
95,Chr5,22853104,22854055,22853580,951
95,Chr5,25794984,25795583,25795284,599
95,Chr5,26842976,26845718,26844347,2742
96,Chr1,2433507,2435777,2434642,2270
96,Chr1,15983029,15983742,15983385,713
96,Chr1,23806861,23807270,23807065,409
96,Chr1,26903771,26904015,26903893,244
96,Chr1,28888045,28890014,28889029,1969
96,Chr2,1170362,1172593,1171478,2231
96,Chr2,8325431,8325977,8325704,546
96,Chr2,15284644,15285236,15284940,592
96,Chr2,17040670,17041750,17041210,1080
96,Chr3,511917,513273,512595,1356
96,Chr3,10707606,10710064,10708835,2458
96,Chr3,20531129,20531962,20531545,833
96,Chr4,186173,186930,186551,757
96,Chr4,10007430,10007762,10007596,332
96,Chr4,17955293,17955603,17955448,310
96,Chr5,1493590,1493747,1493668,157
96,Chr5,3786712,3787263,3786988,551
96,Chr5,21763740,21765750,21764745,2010
96,Chr5,26967224,26967910,26967567,686
